,county,dem_votes,precinct,rep_votes,total,prop
1246,FULTON,64,04C,0,64,0.0
1489,FULTON,35,SC17A,0,35,0.0
1241,FULTON,18,03P2,0,18,0.0
1475,FULTON,56,SC08C,0,56,0.0
1479,FULTON,2,SC08G,0,2,0.0
1477,FULTON,270,SC08E,1,271,0.00369003690037
959,DEKALB,486,WADSWORTH ELEM - 05,2,488,0.00409836065574
341,CHATHAM,925,8-11 Butler Elem School,6,931,0.00644468313641
1009,DOUGHERTY,1252,Jackson Heights Elem,12,1264,0.00949367088608
1251,FULTON,398,04J,4,402,0.00995024875622
340,CHATHAM,989,8-10 Carver Heights Comm Ctr,10,999,0.01001001001
1319,FULTON,1183,10C,12,1195,0.0100418410042
817,DEKALB,744,COLUMBIA ELEM,8,752,0.0106382978723
1229,FULTON,183,03B,2,185,0.0108108108108
1335,FULTON,482,11E2,6,488,0.0122950819672
1258,FULTON,640,04W,8,648,0.0123456790123
1395,FULTON,80,CP083,1,81,0.0123456790123
1005,DOUGHERTY,639,Shiloh Baptist Church,8,647,0.0123647604328
1211,FULTON,549,01R,7,556,0.0125899280576
1321,FULTON,509,10E,7,516,0.0135658914729
1324,FULTON,206,10H1,3,209,0.0143540669856
1004,DOUGHERTY,803,Carver Teen Center,12,815,0.0147239263804
1542,FULTON,200,UC01B,3,203,0.0147783251232
304,CHATHAM,1444,5-05 Liberty City Comm Ctr,22,1466,0.0150068212824
339,CHATHAM,701,8-09 Moses Jackson Ctr,11,712,0.0154494382022
1317,FULTON,1621,10A,26,1647,0.0157862780814
1346,FULTON,556,12D,9,565,0.0159292035398
1502,FULTON,555,SC30B,9,564,0.0159574468085
1002,DOUGHERTY,1787,Mt. Zion Center,29,1816,0.0159691629956
1257,FULTON,1157,04V,19,1176,0.016156462585
1354,FULTON,243,12L,4,247,0.0161943319838
1351,FULTON,419,12I,7,426,0.0164319248826
905,DEKALB,2569,OAK VIEW ELEM,43,2612,0.0164624808576
1256,FULTON,531,04T,9,540,0.0166666666667
1401,FULTON,1001,EP04-13,17,1018,0.016699410609
1470,FULTON,408,SC05A,7,415,0.0168674698795
1020,DOUGHERTY,641,Lovett Hall,11,652,0.0168711656442
336,CHATHAM,456,8-06 Tompkins Rec Ctr,8,464,0.0172413793103
338,CHATHAM,840,8-08 Resur Of Our Lord Ch,15,855,0.0175438596491
893,DEKALB,2004,MILLER GROVE MIDDLE,36,2040,0.0176470588235
1390,FULTON,55,CP05B,1,56,0.0178571428571
1493,FULTON,110,SC19A,2,112,0.0178571428571
855,DEKALB,2200,HARRIS-NARVIE J. HARRIS ELEM,40,2240,0.0178571428571
1333,FULTON,1813,11C,33,1846,0.0178764897075
1341,FULTON,1527,11M,28,1555,0.0180064308682
2311,RICHMOND,545,203,10,555,0.018018018018
1242,FULTON,322,03S,6,328,0.0182926829268
1352,FULTON,1169,12J,22,1191,0.0184718723762
1254,FULTON,313,04M,6,319,0.0188087774295
1343,FULTON,939,11P,18,957,0.0188087774295
1255,FULTON,1079,04S,21,1100,0.0190909090909
1314,FULTON,507,09I,10,517,0.0193423597679
1003,DOUGHERTY,498,Alice Coachman Elem,10,508,0.0196850393701
1396,FULTON,199,CP08A,4,203,0.0197044334975
1308,FULTON,1433,09C,29,1462,0.0198358413133
1337,FULTON,931,11G,19,950,0.02
1230,FULTON,682,03C,14,696,0.0201149425287
875,DEKALB,1600,LITHONIA HIGH,33,1633,0.0202082057563
909,DEKALB,1160,PANOLA ROAD,24,1184,0.0202702702703
1309,FULTON,858,09D,18,876,0.0205479452055
1244,FULTON,476,04A,10,486,0.0205761316872
2291,RANDOLPH,238,Cuthbert,5,243,0.0205761316872
1357,FULTON,903,12S,19,922,0.0206073752711
1393,FULTON,427,CP07A,9,436,0.0206422018349
303,CHATHAM,517,5-03 Butler Presbyterian,11,528,0.0208333333333
1488,FULTON,2771,SC16,59,2830,0.0208480565371
843,DEKALB,1127,FLAT SHOALS ELEM,24,1151,0.0208514335361
2313,RICHMOND,751,207,16,767,0.0208604954368
1234,FULTON,281,03G,6,287,0.0209059233449
1336,FULTON,1672,11E3,36,1708,0.0210772833724
1332,FULTON,2911,11B,63,2974,0.0211835911231
2298,RICHMOND,732,103,16,748,0.0213903743316
1344,FULTON,731,11R,16,747,0.0214190093708
844,DEKALB,1187,FLAT SHOALS LIBRARY,26,1213,0.0214344600165
877,DEKALB,2298,MARBUT ELEM,51,2349,0.021711366539
1331,FULTON,360,10R,8,368,0.0217391304348
1355,FULTON,1213,12M,27,1240,0.0217741935484
1476,FULTON,314,SC08D,7,321,0.0218068535826
1356,FULTON,357,12N,8,365,0.0219178082192
1342,FULTON,1327,11N,30,1357,0.0221075902727
866,DEKALB,2801,KING-ML KING JR HIGH,64,2865,0.0223385689354
1329,FULTON,1175,10M,27,1202,0.022462562396
1334,FULTON,595,11E1,14,609,0.0229885057471
1348,FULTON,423,12F,10,433,0.0230946882217
1247,FULTON,674,04D,16,690,0.0231884057971
842,DEKALB,1095,FLAT SHOALS,26,1121,0.0231935771632
1318,FULTON,2346,10B,56,2402,0.0233139050791
1498,FULTON,290,SC23B,7,297,0.023569023569
1323,FULTON,786,10G,19,805,0.023602484472
1245,FULTON,890,04B,22,912,0.0241228070175
1340,FULTON,1041,11K,26,1067,0.0243673851921
1330,FULTON,674,10P,17,691,0.0246020260492
1350,FULTON,1605,12H,41,1646,0.0249088699878
1484,FULTON,900,SC11B,23,923,0.0249187432286
1235,FULTON,351,03H,9,360,0.025
840,DEKALB,1130,FLAKES MILL FIRE STATION,29,1159,0.0250215703192
809,DEKALB,1907,CHAPEL HILL ELEM,49,1956,0.0250511247444
1228,FULTON,735,03A,19,754,0.025198938992
1483,FULTON,807,SC11A,21,828,0.0253623188406
1260,FULTON,307,04X2,8,315,0.0253968253968
1320,FULTON,1953,10D,51,2004,0.0254491017964
335,CHATHAM,642,8-05 W Broad St YMCA,17,659,0.0257966616085
1252,FULTON,1092,04K,29,1121,0.0258697591436
943,DEKALB,1918,SOUTH DESHON,51,1969,0.0259014728288
1249,FULTON,299,04G,8,307,0.0260586319218
1327,FULTON,411,10J,11,422,0.0260663507109
1231,FULTON,370,03D,10,380,0.0263157894737
962,DEKALB,1881,WESLEY CHAPEL LIBRARY,51,1932,0.026397515528
1212,FULTON,771,01S,21,792,0.0265151515152
95,BIBB,949,EAST MACON 1,26,975,0.0266666666667
838,DEKALB,2250,FAIRINGTON ELEM,62,2312,0.0268166089965
892,DEKALB,1447,MILLER GROVE HIGH,40,1487,0.0268997982515
922,DEKALB,2055,REDAN-TROTTI LIBRARY,57,2112,0.0269886363636
1500,FULTON,1579,SC29A,44,1623,0.0271102895872
1339,FULTON,933,11J,26,959,0.0271115745568
805,DEKALB,813,CEDAR GROVE MIDDLE,23,836,0.0275119617225
883,DEKALB,1376,MCWILLIAMS,39,1415,0.0275618374558
880,DEKALB,1124,MCNAIR ACADEMY,32,1156,0.0276816608997
818,DEKALB,948,COLUMBIA MIDDLE,27,975,0.0276923076923
1501,FULTON,70,SC30A,2,72,0.0277777777778
801,DEKALB,1081,CANBY LANE ELEM,31,1112,0.0278776978417
910,DEKALB,970,PANOLA WAY ELEM,28,998,0.0280561122244
1210,FULTON,547,01P,16,563,0.0284191829485
1325,FULTON,1055,10H2,31,1086,0.0285451197053
1543,FULTON,68,UC01E,2,70,0.0285714285714
865,DEKALB,1492,KELLEY LAKE ELEM,44,1536,0.0286458333333
1471,FULTON,1970,SC05B,59,2029,0.029078363726
1492,FULTON,3092,SC18B,93,3185,0.0291993720565
1315,FULTON,1827,09K,55,1882,0.029224229543
2309,RICHMOND,721,201,22,743,0.0296096904441
1474,FULTON,1868,SC08B,57,1925,0.0296103896104
971,DEKALB,1143,YOUNG ROAD,35,1178,0.0297113752122
1481,FULTON,1012,SC09B,31,1043,0.0297219558965
1499,FULTON,1238,SC27,38,1276,0.0297805642633
1497,FULTON,2893,SC23A,89,2982,0.0298457411133
1400,FULTON,2488,EP04-05,77,2565,0.0300194931774
1491,FULTON,290,SC18A,9,299,0.0301003344482
1467,FULTON,2635,SC01B,82,2717,0.0301803459698
2300,RICHMOND,382,105,12,394,0.0304568527919
1394,FULTON,127,CP081,4,131,0.030534351145
1259,FULTON,888,04X1,28,916,0.0305676855895
932,DEKALB,2151,SALEM MIDDLE,68,2219,0.0306444344299
1468,FULTON,595,SC02,19,614,0.0309446254072
1322,FULTON,556,10F,18,574,0.0313588850174
963,DEKALB,1327,WHITE OAK,43,1370,0.0313868613139
816,DEKALB,1141,COLUMBIA DRIVE,37,1178,0.0314091680815
1494,FULTON,677,SC19B,22,699,0.0314735336195
789,DEKALB,2398,BETHUNE MIDDLE,78,2476,0.0315024232633
955,DEKALB,920,TONEY ELEM,30,950,0.0315789473684
882,DEKALB,1221,MCNAIR MIDDLE,40,1261,0.0317208564631
470,CLAYTON,1082,OAK 1,36,1118,0.0322003577818
919,DEKALB,1707,REDAN ELEM,57,1764,0.0323129251701
806,DEKALB,2235,CEDAR GROVE SOUTH,75,2310,0.0324675324675
1204,FULTON,565,01C,19,584,0.0325342465753
1307,FULTON,178,09B,6,184,0.0326086956522
841,DEKALB,1705,FLAT ROCK ELEM,58,1763,0.0328984685196
845,DEKALB,2080,FLAT SHOALS PARKWAY,71,2151,0.0330079033008
960,DEKALB,1054,WADSWORTH ELEM - 04,36,1090,0.0330275229358
799,DEKALB,2293,BROWNS MILL ELEM,80,2373,0.0337126000843
1209,FULTON,1116,01J,39,1155,0.0337662337662
918,DEKALB,2162,RAINBOW ELEM,76,2238,0.0339588918677
1486,FULTON,510,SC14,18,528,0.0340909090909
1253,FULTON,708,04L,25,733,0.0341064120055
894,DEKALB,1330,MILLER GROVE ROAD,47,1377,0.0341321713871
1482,FULTON,761,SC10,27,788,0.0342639593909
473,CLAYTON,1627,OAK 4,59,1686,0.0349940688019
1338,FULTON,328,11H,12,340,0.0352941176471
1495,FULTON,729,SC211,27,756,0.0357142857143
1207,FULTON,429,01F,16,445,0.0359550561798
308,CHATHAM,1742,5-10 Jonesville Bapt Church,65,1807,0.0359712230216
804,DEKALB,2431,CEDAR GROVE ELEM,91,2522,0.0360824742268
485,CLAYTON,1144,RIVERDALE 10,43,1187,0.0362257792755
884,DEKALB,1747,MEADOWVIEW ELEM,66,1813,0.0364037506895
1310,FULTON,1181,09E,45,1226,0.036704730832
2154,MUSCOGEE,2089,CARVER/MACK,80,2169,0.0368833563854
337,CHATHAM,311,8-07 Woodville-Tompkins,12,323,0.0371517027864
868,DEKALB,1185,KNOLLWOOD ELEM,46,1231,0.0373679935012
942,DEKALB,1190,SNAPFINGER ROAD SOUTH,47,1237,0.0379951495554
1328,FULTON,809,10K,32,841,0.038049940547
472,CLAYTON,1689,OAK 3,67,1756,0.0381548974943
953,DEKALB,1403,TERRY MILL ELEM,56,1459,0.0383824537354
1391,FULTON,847,CP051,34,881,0.0385925085131
1239,FULTON,843,03N,34,877,0.0387685290764
1544,FULTON,3793,UC02A,154,3947,0.0390169749177
940,DEKALB,1091,SNAPFINGER ELEM,45,1136,0.0396126760563
1006,DOUGHERTY,627,Litman Cathedral,26,653,0.0398162327718
917,DEKALB,1296,PRINCETON ELEM,54,1350,0.04
269,CHATHAM,1532,2-04 Fellowship of Love,64,1596,0.0401002506266
1480,FULTON,1691,SC09A,71,1762,0.0402951191827
1487,FULTON,3791,SC15,160,3951,0.0404960769425
815,DEKALB,919,CLIFTON ELEM,39,958,0.0407098121086
1490,FULTON,626,SC17C,27,653,0.04134762634
941,DEKALB,1186,SNAPFINGER ROAD NORTH,52,1238,0.0420032310178
914,DEKALB,911,PINEY GROVE,40,951,0.0420609884332
921,DEKALB,1427,REDAN ROAD,63,1490,0.0422818791946
1326,FULTON,226,10I,10,236,0.0423728813559
928,DEKALB,2145,ROCKBRIDGE ROAD,97,2242,0.0432649420161
1232,FULTON,857,03E,39,896,0.0435267857143
1345,FULTON,2309,12A,106,2415,0.0438923395445
968,DEKALB,3149,WOODROW ROAD,145,3294,0.0440194292653
2343,RICHMOND,1042,607,48,1090,0.0440366972477
864,DEKALB,802,KELLEY CHAPEL ROAD,37,839,0.0441001191895
1243,FULTON,689,03T,32,721,0.0443828016644
1347,FULTON,538,12E1,25,563,0.044404973357
802,DEKALB,1533,CANDLER,72,1605,0.0448598130841
934,DEKALB,2464,SHADOW ROCK ELEM,116,2580,0.0449612403101
944,DEKALB,1890,SOUTH HAIRSTON,89,1979,0.044972208186
1541,FULTON,1656,UC01A,78,1734,0.0449826989619
925,DEKALB,1508,ROCK CHAPEL ELEM,72,1580,0.0455696202532
790,DEKALB,1106,BOULDERCREST RD,53,1159,0.0457290767903
1000,DOUGHERTY,1752,Westtown Elem School,84,1836,0.0457516339869
2165,MUSCOGEE,2925,MT. PILGRIM,141,3066,0.045988258317
477,CLAYTON,1573,RIVERDALE 2,76,1649,0.0460885385082
878,DEKALB,1686,MATHIS-BOB MATHIS ELEM,83,1769,0.0469191633691
1353,FULTON,1259,12K,62,1321,0.0469341408024
823,DEKALB,1569,CROSSROADS,78,1647,0.0473588342441
1389,FULTON,20,CP04,1,21,0.047619047619
1237,FULTON,200,03L,10,210,0.047619047619
96,BIBB,1993,EAST MACON 2,100,2093,0.0477783086479
891,DEKALB,1730,MILLER-ELDRIDGE L. MILLER ELEM,87,1817,0.0478811227298
1018,DOUGHERTY,653,Lamar Reese Elem School,33,686,0.0481049562682
1399,FULTON,3211,EP03,163,3374,0.0483106105513
1264,FULTON,59,05C,3,62,0.0483870967742
920,DEKALB,1376,REDAN MIDDLE,70,1446,0.0484094052559
98,BIBB,1229,EAST MACON 4,63,1292,0.0487616099071
478,CLAYTON,1674,RIVERDALE 3,86,1760,0.0488636363636
1008,DOUGHERTY,368,Turner Elem School,19,387,0.0490956072351
2162,MUSCOGEE,2412,CUSSETA RD,125,2537,0.0492707922743
1478,FULTON,347,SC08F,18,365,0.0493150684932
438,CLAYTON,2014,JONESBORO 2,108,2122,0.0508953817154
713,COOK,261,Elm Pine,14,275,0.0509090909091
2327,RICHMOND,1232,401,67,1299,0.0515781370285
821,DEKALB,349,COVINGTON HWY LIBRARY,19,368,0.0516304347826
785,DEKALB,1101,AUSTIN DRIVE,60,1161,0.0516795865633
1208,FULTON,364,01H,20,384,0.0520833333333
1403,FULTON,341,FA01B,19,360,0.0527777777778
2516,TROUP,1142,GRIGGS CENTER,64,1206,0.0530679933665
852,DEKALB,1756,GRESHAM ROAD,99,1855,0.0533692722372
1485,FULTON,1440,SC13,82,1522,0.053876478318
279,CHATHAM,772,3-04 First African Baptist,44,816,0.0539215686275
506,COBB,2450,Bryant 02,140,2590,0.0540540540541
1392,FULTON,208,CP06A,12,220,0.0545454545455
851,DEKALB,965,GLENWOOD ROAD,56,1021,0.0548481880509
471,CLAYTON,693,OAK 2,41,734,0.0558583106267
2363,RICHMOND,506,809,30,536,0.0559701492537
952,DEKALB,765,STONEVIEW ELEM,46,811,0.0567200986436
486,CLAYTON,982,RIVERDALE 11,60,1042,0.0575815738964
1265,FULTON,98,05D,6,104,0.0576923076923
908,DEKALB,829,PANOLA,51,880,0.0579545454545
970,DEKALB,2075,WYNBROOKE ELEM,128,2203,0.0581025873808
505,COBB,1190,Bryant 01,74,1264,0.0585443037975
946,DEKALB,2026,STEPHENSON MIDDLE,126,2152,0.0585501858736
945,DEKALB,1871,STEPHENSON HIGH,117,1988,0.0588531187123
886,DEKALB,1181,MEMORIAL SOUTH,74,1255,0.0589641434263
2155,MUSCOGEE,2843,ST JOHN/BELVEDERE,179,3022,0.0592322964924
1496,FULTON,1714,SC212,108,1822,0.059275521405
881,DEKALB,2026,MCNAIR HIGH,130,2156,0.0602968460111
1268,FULTON,1208,05K,78,1286,0.0606531881804
2299,RICHMOND,1440,104,93,1533,0.0606653620352
1263,FULTON,815,05B,53,868,0.0610599078341
1349,FULTON,414,12G,27,441,0.0612244897959
887,DEKALB,1727,METROPOLITAN,114,1841,0.0619228680065
1213,FULTON,674,01T,46,720,0.0638888888889
967,DEKALB,1799,WOODRIDGE ELEM,123,1922,0.0639958376691
430,CLAYTON,3156,ELLENWOOD,218,3374,0.0646117368109
929,DEKALB,1556,ROWLAND ELEM,108,1664,0.0649038461538
947,DEKALB,1239,STONE MILL ELEM,87,1326,0.0656108597285
100,BIBB,2669,GODFREY 1,189,2858,0.0661301609517
487,CLAYTON,1497,RIVERDALE 12,110,1607,0.0684505289359
444,CLAYTON,1562,JONESBORO 8,115,1677,0.0685748360167
890,DEKALB,1289,MIDWAY ELEM,98,1387,0.0706560922855
453,CLAYTON,2141,JONESBORO 17,164,2305,0.0711496746204
480,CLAYTON,1409,RIVERDALE 5,108,1517,0.0711931443639
800,DEKALB,1725,BURGESS ELEM,133,1858,0.0715823466093
468,CLAYTON,1457,MORROW 8,114,1571,0.0725652450668
803,DEKALB,1695,CANDLER-MURPHEY CANDLER ELEM,133,1828,0.0727571115974
1216,FULTON,1076,02C,86,1162,0.0740103270224
1262,FULTON,1463,05A2,117,1580,0.0740506329114
911,DEKALB,986,PEACHCREST ELEM,79,1065,0.0741784037559
2333,RICHMOND,2114,502,171,2285,0.0748358862144
1226,FULTON,370,02S,30,400,0.075
1016,DOUGHERTY,849,Albany Middle School,69,918,0.0751633986928
2166,MUSCOGEE,2162,FAITH TABERNACLE,176,2338,0.0752780153978
1205,FULTON,243,01D,20,263,0.0760456273764
448,CLAYTON,1322,JONESBORO 12,109,1431,0.0761705101328
874,DEKALB,618,LITHONIA,51,669,0.0762331838565
122,BIBB,1471,VINEVILLE 3,122,1593,0.0765850596359
951,DEKALB,1036,STONE MOUNTAIN MIDDLE,87,1123,0.0774710596616
2402,SPALDING,855,FAIRMONT,72,927,0.0776699029126
1472,FULTON,1470,SC05D,124,1594,0.077791718946
926,DEKALB,1989,ROCK CHAPEL ROAD,168,2157,0.0778859527121
964,DEKALB,2006,WHITEFOORD ELEM,170,2176,0.078125
476,CLAYTON,1234,RIVERDALE 1,106,1340,0.0791044776119
101,BIBB,767,GODFREY 2,67,834,0.0803357314149
848,DEKALB,804,GLENHAVEN,71,875,0.0811428571429
832,DEKALB,2095,EAST LAKE ELEM,186,2281,0.0815431828146
2488,THOMAS,770,Resource Center,69,839,0.0822407628129
2330,RICHMOND,2265,405,204,2469,0.0826245443499
927,DEKALB,1506,ROCKBRIDGE ELEM,136,1642,0.0828258221681
1248,FULTON,821,04F,75,896,0.0837053571429
791,DEKALB,2575,BOULEVARD,236,2811,0.0839558875845
1803,HALL,1188,22-Gainesville II,109,1297,0.0840400925212
1010,DOUGHERTY,1097,Bill Miller Center,101,1198,0.0843071786311
924,DEKALB,1070,RENFROE MIDDLE,99,1169,0.0846877673225
608,COBB,905,Riverside 01,84,989,0.0849342770475
1202,FULTON,1810,01A,168,1978,0.0849342770475
344,CHATHAM,693,8-15 Garden City Rec Ctr,65,758,0.0857519788918
1250,FULTON,452,04I,43,495,0.0868686868687
437,CLAYTON,2160,JONESBORO 1,207,2367,0.0874524714829
302,CHATHAM,354,5-02 Senior Citizens Cent,34,388,0.0876288659794
814,DEKALB,2387,CLARKSTON,230,2617,0.0878868933894
1583,GLYNN,1366,Burroughs,132,1498,0.0881174899866
1206,FULTON,2803,01E,273,3076,0.0887516254876
461,CLAYTON,1314,MORROW 1,128,1442,0.0887656033287
820,DEKALB,846,COVINGTON,83,929,0.0893433799785
2331,RICHMOND,1719,406,170,1889,0.0899947061938
2303,RICHMOND,282,108,28,310,0.0903225806452
1266,FULTON,70,05F,7,77,0.0909090909091
102,BIBB,1500,GODFREY 3,153,1653,0.0925589836661
1261,FULTON,1398,05A1,143,1541,0.0927968851395
930,DEKALB,1044,ROWLAND ROAD,107,1151,0.0929626411816
907,DEKALB,1856,OAKHURST,192,2048,0.09375
1398,FULTON,2558,EP02,265,2823,0.0938717676231
965,DEKALB,1303,WINNONA PARK ELEM,135,1438,0.0938803894298
1397,FULTON,2507,EP01,261,2768,0.0942919075145
2328,RICHMOND,1381,402,145,1526,0.0950196592398
1203,FULTON,2226,01B,234,2460,0.0951219512195
846,DEKALB,1520,FREEDOM MIDDLE,161,1681,0.0957763236169
406,CLARKE,2035,2B Howard Stroud School,216,2251,0.0959573522879
460,CLAYTON,1363,LOVEJOY 5,147,1510,0.0973509933775
836,DEKALB,2603,EPWORTH,281,2884,0.0974341192788
483,CLAYTON,1468,RIVERDALE 8,159,1627,0.0977258758451
780,DEKALB,1571,ALLGOOD ELEM,172,1743,0.0986804360298
1217,FULTON,2087,02D,229,2316,0.0988773747841
788,DEKALB,847,AVONDALE HIGH - 05,93,940,0.0989361702128
479,CLAYTON,1738,RIVERDALE 4,192,1930,0.099481865285
1024,DOUGLAS,1608,COLONIAL HILLS,180,1788,0.10067114094
1220,FULTON,400,02F2,45,445,0.101123595506
1473,FULTON,2989,SC07A,337,3326,0.101322910403
901,DEKALB,1072,NORTH HAIRSTON,121,1193,0.101424979044
270,CHATHAM,952,2-05 Holy Spirit Lutheran,108,1060,0.101886792453
123,BIBB,1937,VINEVILLE 4,223,2160,0.103240740741
459,CLAYTON,2014,LOVEJOY 4,232,2246,0.103294746215
103,BIBB,885,GODFREY 4,103,988,0.104251012146
916,DEKALB,1507,PONCE DE LEON,178,1685,0.105637982196
2307,RICHMOND,406,114,48,454,0.105726872247
1816,HANCOCK,270,Second Beulah,32,302,0.105960264901
484,CLAYTON,1225,RIVERDALE 9,146,1371,0.106491611962
853,DEKALB,1645,HAMBRICK ELEM,197,1842,0.106948968512
451,CLAYTON,1047,JONESBORO 15,128,1175,0.108936170213
278,CHATHAM,472,3-03 Savannah High School,58,530,0.109433962264
407,CLARKE,1060,3A Clarke Central High,131,1191,0.109991603694
413,CLARKE,1243,5C Chase Street School,154,1397,0.110236220472
1221,FULTON,1893,02G,236,2129,0.110850164396
1219,FULTON,1633,02F1,208,1841,0.112982074959
948,DEKALB,1231,STONE MOUNTAIN CHAMPION,158,1389,0.113750899928
2240,PEACH,1572,FORT VALLEY #3,203,1775,0.114366197183
446,CLAYTON,1221,JONESBORO 10,158,1379,0.11457577955
1267,FULTON,332,05J,43,375,0.114666666667
2329,RICHMOND,908,404,118,1026,0.115009746589
1218,FULTON,1154,02E,150,1304,0.115030674847
273,CHATHAM,1553,2-09 The Salvation Army,202,1755,0.1150997151
104,BIBB,2183,GODFREY 5,285,2468,0.115478119935
455,CLAYTON,1173,LAKE CITY,154,1327,0.116051243406
1014,DOUGHERTY,1196,Phoebe East,158,1354,0.116691285081
1690,GWINNETT,2166,MARTINS E,288,2454,0.117359413203
2549,UPSON,240,SALEM,32,272,0.117647058824
913,DEKALB,352,PINE LAKE,47,399,0.117794486216
828,DEKALB,986,DUNAIRE ELEM,133,1119,0.118856121537
2316,RICHMOND,818,210,111,929,0.119483315393
1222,FULTON,1178,02J,160,1338,0.119581464873
1402,FULTON,4055,FA01A,551,4606,0.119626574034
2401,SPALDING,739,SECOND BAPTISH CH,101,840,0.120238095238
849,DEKALB,559,GLENNWOOD - 04,77,636,0.12106918239
2332,RICHMOND,1622,501,224,1846,0.121343445287
457,CLAYTON,1411,LOVEJOY 2,196,1607,0.121966397013
452,CLAYTON,905,JONESBORO 16,126,1031,0.122211445199
474,CLAYTON,1548,PANHANDLE 1,217,1765,0.122946175637
2050,LOWNDES,1573,Mildred,221,1794,0.123188405797
1034,DOUGLAS,1402,STEWART,200,1602,0.124843945069
1818,HANCOCK,374,Power of God,54,428,0.126168224299
2325,RICHMOND,1465,309,212,1677,0.126416219439
850,DEKALB,718,GLENNWOOD - 05,104,822,0.126520681265
936,DEKALB,1700,SHAW-ROBERT SHAW ELEM,247,1947,0.126861838726
1881,HENRY,2090,SHAKERAG,306,2396,0.127712854758
1814,HANCOCK,321,St. Mark,47,368,0.127717391304
1279,FULTON,239,06Q,35,274,0.127737226277
275,CHATHAM,655,2-12 Williams Court Apts,96,751,0.127829560586
1223,FULTON,783,02K,115,898,0.128062360802
895,DEKALB,965,MONTCLAIR ELEM,142,1107,0.128274616079
105,BIBB,1547,HAZZARD 1,230,1777,0.129431626337
2168,MUSCOGEE,3110,ROTHSCHILD,464,3574,0.129826524902
482,CLAYTON,895,RIVERDALE 7,134,1029,0.130223517979
1114,FAYETTE,1903,EUROPE,286,2189,0.130653266332
1240,FULTON,1534,03P1A,235,1769,0.132843414358
272,CHATHAM,1275,2-07 Christ Comm. Church,196,1471,0.133242692046
454,CLAYTON,1340,JONESBORO 18,206,1546,0.133247089263
271,CHATHAM,239,2-06 Eli Whitney,37,276,0.134057971014
1547,FULTON,71,UC032,11,82,0.134146341463
861,DEKALB,842,INDIAN CREEK ELEM,133,975,0.13641025641
268,CHATHAM,674,2-03 W. W. Law Center,108,782,0.13810741688
2338,RICHMOND,1089,509,175,1264,0.138449367089
481,CLAYTON,1213,RIVERDALE 6,195,1408,0.138494318182
2418,SPALDING,759,COMMUNITY,123,882,0.139455782313
1274,FULTON,1393,06I,226,1619,0.139592340951
305,CHATHAM,1004,5-06 Wildwood United Meth,163,1167,0.139674378749
1215,FULTON,1019,02B,166,1185,0.140084388186
283,CHATHAM,1225,3-10 Bible Baptist Church,200,1425,0.140350877193
812,DEKALB,1995,CLAIREMONT WEST,329,2324,0.14156626506
1388,FULTON,428,CP02,71,499,0.142284569138
1031,DOUGLAS,2043,GOLDEN METHODIST CH,342,2385,0.143396226415
2163,MUSCOGEE,1854,NATIONAL INFANTRY,311,2165,0.143648960739
465,CLAYTON,2415,MORROW 5,407,2822,0.144223954642
1692,GWINNETT,753,PINCKNEYVILLE Q,127,880,0.144318181818
873,DEKALB,1748,LIN-MARY LIN ELEM,297,2045,0.145232273839
1273,FULTON,282,06G,48,330,0.145454545455
787,DEKALB,949,AVONDALE HIGH - 04,164,1113,0.14734950584
1313,FULTON,449,09H,78,527,0.148007590133
2203,NEWTON,2109,Crowell,367,2476,0.148222940226
1875,HENRY,1988,STOCKBRIDGE WEST,348,2336,0.14897260274
863,DEKALB,1398,JOLLY ELEM,246,1644,0.149635036496
1868,HENRY,2813,RED OAK,496,3309,0.149894227863
456,CLAYTON,1771,LOVEJOY 1,313,2084,0.15019193858
811,DEKALB,1963,CLAIREMONT EAST,350,2313,0.151318633809
827,DEKALB,1554,DRUID HILLS HIGH,279,1833,0.152209492635
1669,GWINNETT,958,PINCKNEYVILLE J,172,1130,0.152212389381
2455,TAYLOR,549,#1 BUTLER FIRE DEPT.,99,648,0.152777777778
2083,MCDUFFIE,885,Thomson Depot,160,1045,0.153110047847
1817,HANCOCK,176,Mayfield Comm Center,32,208,0.153846153846
900,DEKALB,860,NORTH DECATUR,157,1017,0.154375614553
2334,RICHMOND,1852,503,340,2192,0.155109489051
2398,SEMINOLE,500,Precinct 3,92,592,0.155405405405
1236,FULTON,613,03I,113,726,0.15564738292
469,CLAYTON,607,MORROW 9,112,719,0.155771905424
1233,FULTON,877,03F,162,1039,0.155919153032
463,CLAYTON,1823,MORROW 3,337,2160,0.156018518519
834,DEKALB,663,EMORY ROAD,124,787,0.157560355781
1224,FULTON,2773,02L1,520,3293,0.157910719708
1527,FULTON,943,SS15A,177,1120,0.158035714286
2202,NEWTON,1155,Fairview,217,1372,0.158163265306
432,CLAYTON,953,FOREST PARK 2,183,1136,0.161091549296
449,CLAYTON,946,JONESBORO 13,182,1128,0.16134751773
2368,ROCKDALE,2020,Fieldstone,389,2409,0.161477791615
879,DEKALB,1124,MCLENDON,217,1341,0.161819537658
1272,FULTON,1385,06F,272,1657,0.164152082076
2167,MUSCOGEE,2710,FORT/WADDELL,533,3243,0.164353993216
333,CHATHAM,727,8-02 Bull Street Baptist,143,870,0.164367816092
915,DEKALB,1661,PLEASANTDALE ELEM,329,1990,0.165326633166
188,CALHOUN,240,Edison,48,290,0.165517241379
1269,FULTON,925,06B,184,1109,0.165915238954
2433,SUMTER,1276,Rec Dept,254,1530,0.166013071895
274,CHATHAM,768,2-11 S Gardens Christian,153,921,0.166123778502
1045,DOUGLAS,1959,BOUNDARY WATERS,391,2350,0.166382978723
2500,TIFT,1109,Mott-Littman Gym,223,1332,0.167417417417
2314,RICHMOND,1131,208,228,1359,0.167770419426
466,CLAYTON,1203,MORROW 6,243,1446,0.168049792531
1661,GWINNETT,794,MARTINS D,162,956,0.169456066946
2305,RICHMOND,614,111,126,740,0.17027027027
2474,THOMAS,1003,Douglass,206,1209,0.170388751034
1271,FULTON,1149,06E,236,1385,0.170397111913
1863,HENRY,2590,WESTSIDE,534,3124,0.170934699104
39,BALDWIN,532,East Hardwick,110,642,0.171339563863
1275,FULTON,1339,06J,279,1618,0.172435105068
435,CLAYTON,1257,FOREST PARK 5,263,1520,0.173026315789
405,CLARKE,1550,2A Judia J. Harris Sch,325,1875,0.173333333333
467,CLAYTON,756,MORROW 7,160,916,0.174672489083
2376,ROCKDALE,2418,Olde Towne,513,2931,0.175025588536
1225,FULTON,549,02L2,117,666,0.175675675676
440,CLAYTON,805,JONESBORO 4,172,977,0.17604912999
458,CLAYTON,2676,LOVEJOY 3,572,3248,0.176108374384
1453,FULTON,514,RW07A,110,624,0.176282051282
439,CLAYTON,1787,JONESBORO 3,384,2171,0.1768770152
1882,HENRY,2215,ELLENWOOD,482,2697,0.178717093066
2442,TALBOT,487,TALBOTTON,106,593,0.178752107926
1007,DOUGHERTY,549,Phoebe Edu. Bldg,120,669,0.179372197309
2059,MACON,658,Montezuma 5,144,802,0.179551122195
596,COBB,2283,Pebblebrook 01,500,2783,0.179662234998
1538,FULTON,1437,SS26,316,1753,0.180262407302
1820,HANCOCK,472,Youth Center,104,576,0.180555555556
1815,HANCOCK,456,Courthouse,101,557,0.181328545781
2109,MITCHELL,944,Camilla North,212,1156,0.18339100346
2656,WILCOX,262,Rochelle North 1,59,321,0.183800623053
1677,GWINNETT,1395,PINCKNEYVILLE N,315,1710,0.184210526316
580,COBB,1206,Marietta 7A,273,1479,0.184584178499
427,CLAY,181,Courthouse,41,222,0.184684684685
1386,FULTON,518,CP011,119,637,0.186813186813
2614,WAYNE,429,VFW,99,528,0.1875
267,CHATHAM,629,2-02 Blackshear Comm Ctr,146,775,0.188387096774
933,DEKALB,1305,SCOTT,303,1608,0.188432835821
1227,FULTON,211,02W,49,260,0.188461538462
30,BALDWIN,533,Boddie,124,657,0.188736681887
539,COBB,2753,Harmony Leland 01,646,3399,0.190055898794
1741,GWINNETT,1207,PINCKNEYVILLE Y,286,1493,0.191560616209
342,CHATHAM,434,8-12 Beach High School,103,537,0.191806331471
443,CLAYTON,1382,JONESBORO 7,328,1710,0.191812865497
2304,RICHMOND,440,109,105,545,0.192660550459
2583,WARE,1737,100,417,2154,0.193593314763
1637,GWINNETT,987,PINCKNEYVILLE A,237,1224,0.19362745098
1290,FULTON,754,07N,182,936,0.194444444444
2094,MERIWETHER,478,MANCHESTER GILL II,116,594,0.195286195286
1546,FULTON,982,UC031,239,1221,0.195741195741
2675,WILKINSON,530,Midway,129,659,0.195751138088
517,COBB,1638,Dobbins 01,400,2038,0.196270853778
1029,DOUGLAS,2636,COUNTY LINE BAPTIST CHURCH,644,3280,0.196341463415
1598,GRADY,1094,Cairo 4th District,269,1363,0.197358767425
839,DEKALB,1300,FERNBANK ELEM,320,1620,0.197530864198
1280,FULTON,813,06R,201,1014,0.198224852071
28,BALDWIN,524,South Milledgeville,131,655,0.2
284,CHATHAM,607,3-11 Southside Bapt Church,152,759,0.200263504611
854,DEKALB,940,HARRIS-MARGARET HARRIS ED,236,1176,0.200680272109
2016,LIBERTY,555,Riceboro Youth Center,140,695,0.201438848921
1270,FULTON,4281,06D,1081,5362,0.20160387915
433,CLAYTON,877,FOREST PARK 3,222,1099,0.202001819836
950,DEKALB,636,STONE MOUNTAIN LIBRARY,161,797,0.202007528231
332,CHATHAM,272,8-01 Civic Center,69,341,0.202346041056
2077,MCDUFFIE,527,Queen of Angels,134,661,0.202723146747
1735,GWINNETT,1518,MARTINS J,387,1905,0.203149606299
2086,MCINTOSH,39,Sapelo Island,10,49,0.204081632653
1214,FULTON,1666,02A,429,2095,0.20477326969
287,CHATHAM,1062,3-14 Riverview Health Reh,276,1338,0.206278026906
1305,FULTON,621,08P,162,783,0.206896551724
1684,GWINNETT,1323,PINCKNEYVILLE O,346,1669,0.207309766327
1238,FULTON,325,03M,85,410,0.207317073171
1655,GWINNETT,760,PINCKNEYVILLE E,199,959,0.207507820647
431,CLAYTON,1011,FOREST PARK 1,265,1276,0.207680250784
497,COBB,1995,Austell 1A,523,2518,0.207704527403
1640,GWINNETT,723,PINCKNEYVILLE D,190,913,0.208105147864
2406,SPALDING,839,CITY PARK,221,1060,0.208490566038
1676,GWINNETT,1311,PINCKNEYVILLE K,349,1660,0.210240963855
860,DEKALB,965,IDLEWOOD ELEM,258,1223,0.210956663941
1722,GWINNETT,2635,ROCKBRIDGE F,711,3346,0.212492528392
735,COWETA,954,CENTRAL,259,1213,0.213520197857
1521,FULTON,114,SS11C,31,145,0.213793103448
835,DEKALB,1728,EMORY SOUTH,470,2198,0.213830755232
1312,FULTON,1425,09G,389,1814,0.214443219405
40,BALDWIN,1336,West Hardwick,366,1702,0.215041128085
2019,LIBERTY,741,Memorial Dr. East,203,944,0.215042372881
885,DEKALB,1198,MEDLOCK ELEM,331,1529,0.216481360366
862,DEKALB,689,JOHNSON ESTATES,191,880,0.217045454545
2164,MUSCOGEE,1329,EDDY/KEY,370,1699,0.21777516186
1768,GWINNETT,876,DULUTH K,244,1120,0.217857142857
445,CLAYTON,470,JONESBORO 9,131,601,0.217970049917
1740,GWINNETT,2422,ROCKBRIDGE G,676,3098,0.218205293738
1316,FULTON,963,09M,270,1233,0.21897810219
1693,GWINNETT,2297,ROCKBRIDGE C,646,2943,0.219503907577
1276,FULTON,472,06L1,133,605,0.219834710744
99,BIBB,1120,EAST MACON 5,317,1437,0.220598469033
1874,HENRY,890,STOCKBRIDGE EAST,252,1142,0.220665499124
1387,FULTON,563,CP012,161,724,0.222375690608
604,COBB,1450,Powder Springs 2A,415,1865,0.222520107239
2182,NEWTON,1687,Town,488,2175,0.224367816092
643,COLQUITT,1089,Shaw,317,1406,0.22546230441
447,CLAYTON,1656,JONESBORO 11,483,2139,0.225806451613
1762,GWINNETT,2368,LAWRENCEVILLE M,692,3060,0.22614379085
414,CLARKE,1106,5D ACC Fleet Mgt Bldg,324,1430,0.226573426573
1757,GWINNETT,2085,MARTINS K,611,2696,0.226632047478
1634,GWINNETT,1226,MARTINS A,362,1588,0.227959697733
2193,NEWTON,2068,Beaverdam,617,2685,0.229795158287
813,DEKALB,1422,CLAIRMONT ROAD,425,1847,0.230102869518
792,DEKALB,1364,BRIAR VISTA ELEM,408,1772,0.230248306998
1135,FAYETTE,517,KENWOOD,156,673,0.231797919762
576,COBB,1244,Marietta 5A,378,1622,0.233045622688
2153,MUSCOGEE,2040,WYNNTON,621,2661,0.233370913191
616,COBB,1589,Smyrna 1A,485,2074,0.233847637416
2464,TERRELL,1395,Dawson,427,1822,0.234357848518
408,CLARKE,2086,3B Thomas N. Lay Park,640,2726,0.234776228907
2478,THOMAS,918,Harper,282,1200,0.235
1911,HOUSTON,3177,RECR,978,4155,0.235379061372
2431,SUMTER,1216,Rees Park,376,1592,0.236180904523
227,CARROLL,1043,WEST CARROLLTON (714A1),323,1366,0.236456808199
1713,GWINNETT,1850,DULUTH F,576,2426,0.237427864798
1306,FULTON,1448,09A,451,1899,0.237493417588
2024,LIBERTY,908,Walthourville,283,1191,0.237615449202
1822,HANCOCK,80,Sparta 4C,25,105,0.238095238095
514,COBB,1998,Cooper 01,625,2623,0.23827678231
306,CHATHAM,685,5-07 Elks Lodge,215,900,0.238888888889
178,BURKE,1286,North Waynesboro,404,1690,0.239053254438
1169,FLOYD,496,SOUTH ROME,156,652,0.239263803681
2326,RICHMOND,1844,310,580,2424,0.239273927393
309,CHATHAM,1101,5-11 Largo-Tibet Elem,347,1448,0.239640883978
1678,GWINNETT,1732,LAWRENCEVILLE D,547,2279,0.240017551558
1668,GWINNETT,981,PINCKNEYVILLE I,310,1291,0.240123934934
2017,LIBERTY,1344,Lyman Hall School,426,1770,0.240677966102
1619,GWINNETT,1695,ROCKBRIDGE A,538,2233,0.240931482311
2315,RICHMOND,425,209,135,560,0.241071428571
958,DEKALB,469,VALLEY BROOK,149,618,0.241100323625
1734,GWINNETT,1356,MARTINS I,431,1787,0.241186345831
2381,ROCKDALE,1163,St. Pius,371,1534,0.24185136897
577,COBB,905,Marietta 5B,290,1195,0.242677824268
1706,GWINNETT,1768,ROCKBRIDGE E,568,2336,0.243150684932
999,DOUGHERTY,1728,Darton College,556,2284,0.243432574431
1363,FULTON,292,AP03,94,386,0.243523316062
464,CLAYTON,725,MORROW 4,234,959,0.244004171011
1638,GWINNETT,1110,PINCKNEYVILLE B,359,1469,0.244383934649
441,CLAYTON,820,JONESBORO 5,269,1089,0.247015610652
2318,RICHMOND,396,302,130,526,0.247148288973
1704,GWINNETT,911,MARTINS F,304,1215,0.250205761317
301,CHATHAM,396,5-01 Bartlett Middle Sch,133,529,0.251417769376
627,COBB,1137,Sweetwater 02,382,1519,0.251481237656
587,COBB,2088,Nickajack 01,703,2791,0.25188104622
1990,LAURENS,2212,Calhoun Park,745,2957,0.251944538383
578,COBB,908,Marietta 6A,307,1215,0.252674897119
121,BIBB,829,VINEVILLE 2,281,1110,0.253153153153
1721,GWINNETT,1164,BERKSHIRE L,395,1559,0.253367543297
906,DEKALB,701,OAKCLIFF ELEM,238,939,0.25346112886
1629,GWINNETT,2085,BERKSHIRE B,709,2794,0.253758052971
2375,ROCKDALE,1529,Milstead,526,2055,0.25596107056
190,CALHOUN,306,Arlington,107,416,0.257211538462
2367,ROCKDALE,1267,Conyers,439,1706,0.257327080891
280,CHATHAM,733,3-05 Aldersgate Youth Cent,257,990,0.259595959596
856,DEKALB,1677,HAWTHORNE ELEM,590,2267,0.260255844729
824,DEKALB,1077,DORAVILLE NORTH,380,1457,0.260809883322
286,CHATHAM,1289,3-13 New Cov 7 Day Adv Ch,455,1744,0.260894495413
32,BALDWIN,642,Fire Dept,227,869,0.261219792865
1013,DOUGHERTY,426,International Studie,151,577,0.261698440208
1454,FULTON,166,RW07B,59,225,0.262222222222
2301,RICHMOND,331,106,118,449,0.26280623608
871,DEKALB,1329,LAVISTA,474,1803,0.262895174709
617,COBB,2199,Smyrna 2A,785,2984,0.263069705094
1533,FULTON,1209,SS19A,432,1641,0.263254113346
1446,FULTON,1044,PA01,374,1418,0.263751763047
1534,FULTON,882,SS19B,316,1198,0.263772954925
2183,NEWTON,1959,Almon,706,2665,0.264915572233
410,CLARKE,1963,4B Memorial Park,708,2671,0.265069262449
2175,MUSCOGEE,571,FIRST AFRICAN,206,777,0.265122265122
409,CLARKE,723,4A Athens Transit Ctr,261,984,0.265243902439
2297,RICHMOND,519,102,188,707,0.265912305516
2361,RICHMOND,543,807,197,740,0.266216216216
531,COBB,1617,Fair Oaks 02,588,2205,0.266666666667
508,COBB,2134,Chattahoochee 01,780,2914,0.267673301304
553,COBB,2170,Lindley 01,796,2966,0.268374915711
1505,FULTON,515,SS02B,189,704,0.268465909091
1702,GWINNETT,1154,LAWRENCEVILLE G,426,1580,0.269620253165
2369,ROCKDALE,1735,Flat Shoals,641,2376,0.269781144781
786,DEKALB,1483,AVONDALE,550,2033,0.270536153468
1867,HENRY,1925,MT. CARMEL,716,2641,0.271109428247
1689,GWINNETT,1625,LAWRENCEVILLE F,605,2230,0.27130044843
592,COBB,2300,Oregon 02,858,3158,0.271690943635
1956,JEFFERSON,847,Wadley,316,1163,0.271711092003
2021,LIBERTY,887,Town of Allenhurst,331,1218,0.271756978654
935,DEKALB,786,SHAMROCK,297,1083,0.274238227147
475,CLAYTON,1204,PANHANDLE 2,456,1660,0.274698795181
97,BIBB,1282,EAST MACON 3,487,1769,0.275296777841
2654,WHITFIELD,612,5A,233,845,0.27573964497
897,DEKALB,759,MONTREAL,289,1048,0.275763358779
2339,RICHMOND,1255,601,478,1733,0.275822273514
1662,GWINNETT,1618,ROCKBRIDGE B,617,2235,0.276062639821
826,DEKALB,1903,DRESDEN ELEM,726,2629,0.276150627615
2025,LIBERTY,206,Fleming West,79,285,0.277192982456
859,DEKALB,1310,HUNTLEY HILLS ELEM,503,1813,0.277440706012
530,COBB,1564,Fair Oaks 01,603,2167,0.278264882326
2178,MUSCOGEE,842,GALLOPS/HANNAN,327,1169,0.279726261762
872,DEKALB,1016,LAVISTA ROAD,395,1411,0.279943302622
2028,LIBERTY,869,Hinesville Lodge,338,1207,0.280033140017
418,CLARKE,733,6D Firestation #4,287,1020,0.28137254902
2655,WHITFIELD,475,6A,186,661,0.28139183056
315,CHATHAM,808,6-08 Savannah Commons,317,1125,0.281777777778
1728,GWINNETT,856,MARTINS G,339,1195,0.283682008368
949,DEKALB,1030,STONE MOUNTAIN ELEM,408,1438,0.283727399166
2395,SCREVEN,108,Cooperville Fire Station,43,151,0.284768211921
1277,FULTON,317,06L2,127,444,0.286036036036
1682,GWINNETT,1332,GARNERS D,534,1866,0.286173633441
969,DEKALB,974,WOODWARD ELEM,397,1371,0.289569657185
594,COBB,1772,Oregon 04,724,2496,0.290064102564
1404,FULTON,1163,HP01,476,1639,0.290420988408
2499,TIFT,762,Tifton South,313,1075,0.291162790698
912,DEKALB,1417,PEACHTREE MIDDLE,589,2006,0.293619142572
107,BIBB,2659,HAZZARD 3,1106,3765,0.293758300133
825,DEKALB,488,DORAVILLE SOUTH,203,691,0.293777134588
837,DEKALB,1222,EVANSDALE ELEM,510,1732,0.294457274827
1694,GWINNETT,1558,ROCKBRIDGE D,651,2209,0.29470348574
412,CLARKE,1196,5B Whitehead Rd School,500,1696,0.294811320755
1380,FULTON,105,CH01,44,149,0.295302013423
424,CLARKE,1403,8C Firestation #7,588,1991,0.295328980412
2665,WILKES,429,Edward B Pope Center,180,609,0.295566502463
1656,GWINNETT,693,PINCKNEYVILLE F,291,984,0.295731707317
569,COBB,1176,Marietta 1A,497,1673,0.297071129707
819,DEKALB,1565,CORALWOOD,665,2230,0.298206278027
423,CLARKE,863,8B Cedar Shls High Sch,370,1233,0.300081103001
2514,TROUP,1313,ADMINISTRATION BLDG,563,1876,0.300106609808
2337,RICHMOND,317,507,136,453,0.300220750552
605,COBB,1448,Powder Springs 3A,622,2070,0.300483091787
422,CLARKE,1231,8A Gaines School,533,1764,0.302154195011
1979,LAMAR,939,BARNESVILLE FBC,410,1349,0.303928836175
2201,NEWTON,1662,Stansells,726,2388,0.304020100503
2335,RICHMOND,705,504,308,1013,0.304047384008
1890,HENRY,1631,STOCKBRIDGE CENTRAL,714,2345,0.30447761194
2190,NEWTON,1649,Livingston,722,2371,0.304512863771
628,COBB,1982,Terrell Mill 01,869,2851,0.304805331463
2341,RICHMOND,642,604,282,924,0.305194805195
2310,RICHMOND,1555,202,684,2239,0.305493523895
1089,EMANUEL,93,Cross-Green,41,134,0.305970149254
2378,ROCKDALE,1516,Salem,671,2187,0.306812985825
923,DEKALB,979,REHOBOTH,434,1413,0.307147912243
1520,FULTON,470,SS11B,209,679,0.307805596465
810,DEKALB,932,CHESNUT ELEM,415,1347,0.308092056422
1301,FULTON,1577,08L,704,2281,0.308636562911
436,CLAYTON,456,FOREST PARK 6,204,660,0.309090909091
2380,ROCKDALE,1828,Smyrna,818,2646,0.309145880574
1278,FULTON,739,06N,331,1070,0.309345794393
1385,FULTON,149,CP01B,67,216,0.310185185185
1628,GWINNETT,836,BERKSHIRE A,381,1217,0.313064913722
307,CHATHAM,661,5-08 Savannah Primitive,303,964,0.314315352697
889,DEKALB,1289,MIDVALE ROAD,591,1880,0.314361702128
1869,HENRY,2042,WESLEY LAKES,938,2980,0.314765100671
411,CLARKE,1260,5A Oglethorpe School,580,1840,0.315217391304
1742,GWINNETT,929,GOODWINS G,430,1359,0.316409124356
903,DEKALB,683,NORTHLAKE,318,1001,0.317682317682
2239,PEACH,948,FORT VALLEY #2,442,1390,0.317985611511
120,BIBB,1225,VINEVILLE 1,575,1800,0.319444444444
742,COWETA,317,WESTSIDE,149,466,0.31974248927
1040,DOUGLAS,1466,CHESTNUT LOG,690,2156,0.320037105751
281,CHATHAM,461,3-08 Jenkins High School,217,678,0.32005899705
1700,GWINNETT,1652,DULUTH E,779,2431,0.320444261621
1376,FULTON,248,AP12B,117,365,0.320547945205
1285,FULTON,833,07E,395,1228,0.321661237785
513,COBB,2063,Clarkdale 02,981,3044,0.322273324573
564,COBB,1554,Macland 01,740,2294,0.322580645161
902,DEKALB,695,NORTH PEACHTREE,333,1028,0.323929961089
1821,HANCOCK,177,Second Darrien,85,262,0.324427480916
1011,DOUGHERTY,309,Radium Middle School,149,458,0.325327510917
450,CLAYTON,1763,JONESBORO 14,854,2617,0.326327856324
957,DEKALB,1119,TUCKER LIBRARY,543,1662,0.326714801444
321,CHATHAM,1439,7-04 Lake Shore Comm Ctr,700,2139,0.327255726975
2372,ROCKDALE,666,The Lakes,325,991,0.327951564077
593,COBB,1179,Oregon 03,576,1755,0.328205128205
2294,RANDOLPH,112,Springvale,55,167,0.329341317365
961,DEKALB,523,WARREN TECH,258,781,0.330345710627
434,CLAYTON,569,FOREST PARK 4,282,851,0.331374853114
426,CLAY,159,Zetto,79,238,0.331932773109
2359,RICHMOND,271,805,135,406,0.332512315271
2058,MACON,632,Montezuma 4,315,947,0.332629355861
462,CLAYTON,678,MORROW 2,338,1016,0.332677165354
620,COBB,1360,Smyrna 5A,681,2041,0.333659970603
1528,FULTON,586,SS15B,295,881,0.33484676504
2534,TWIGGS,698,JEFFERSONVILLE/WARE,353,1051,0.335870599429
2377,ROCKDALE,1707,Rockdale,866,2573,0.336572094831
2336,RICHMOND,136,506,69,205,0.336585365854
1584,GLYNN,374,Selden Park,190,564,0.336879432624
1044,DOUGLAS,1608,FACTORY SHOALS,817,2425,0.336907216495
1038,DOUGLAS,1588,CHAPEL HILL,807,2395,0.336951983299
2088,MCINTOSH,798,Crescent,406,1204,0.337209302326
2517,TROUP,773,WEST POINT,394,1167,0.337617823479
1015,DOUGHERTY,775,Pine Bluff Bapt Church,396,1171,0.338172502135
857,DEKALB,1299,HENDERSON MILL ELEM,665,1964,0.338594704684
2440,TALBOT,207,JUNCTION CITY,106,313,0.338658146965
1733,GWINNETT,1584,MARTINS H,817,2401,0.340274885464
779,DECATUR,744,Attapulgus,384,1128,0.340425531915
1112,FAYETTE,1214,BLACKROCK,628,1842,0.340933767644
622,COBB,2622,Smyrna 7A,1358,3980,0.341206030151
1635,GWINNETT,1079,MARTINS B,561,1640,0.342073170732
1535,FULTON,712,SS20,371,1083,0.342566943675
797,DEKALB,1042,BROCKETT ELEM,546,1588,0.343828715365
1440,FULTON,670,ML06A,353,1023,0.345063538612
1885,HENRY,1410,SHILOH,743,2153,0.34509986066
1671,GWINNETT,1294,CATES H,683,1977,0.345472938796
1633,GWINNETT,1744,LAWRENCEVILLE B,924,2668,0.346326836582
1513,FULTON,479,SS08A,254,733,0.346521145975
560,COBB,948,Mableton 02,503,1451,0.346657477602
174,BURKE,111,Scotts Crossroads,59,170,0.347058823529
2356,RICHMOND,15,803,8,23,0.347826086957
904,DEKALB,1001,OAK GROVE ELEM,536,1537,0.34873129473
931,DEKALB,1379,SAGAMORE HILLS ELEM,740,2119,0.349221330816
168,BURKE,180,Gough,97,277,0.350180505415
331,CHATHAM,2338,7-14 Coastal Cathedral,1269,3607,0.351815913502
1731,GWINNETT,540,PINCKNEYVILLE V,294,834,0.352517985612
1683,GWINNETT,582,BERKSHIRE H,317,899,0.352614015573
632,COBB,2238,Vinings 02,1221,3459,0.352992194276
559,COBB,1794,Mableton 01,982,2776,0.353746397695
1289,FULTON,747,07M,409,1156,0.353806228374
533,COBB,542,Fair Oaks 05,297,839,0.353992848629
1507,FULTON,1172,SS04,643,1815,0.354269972452
1288,FULTON,1078,07J,592,1670,0.354491017964
524,COBB,1240,Elizabeth 01,685,1925,0.355844155844
1745,GWINNETT,723,LAWRENCEVILLE J,400,1123,0.356188780053
402,CLARKE,1268,1B Gaines School,704,1972,0.356997971602
403,CLARKE,899,1C Whit Davis School,500,1399,0.35739814153
2288,RANDOLPH,314,Shellman,175,489,0.357873210634
155,BULLOCH,1880,Pittman Park,1052,2932,0.358799454297
1375,FULTON,248,AP12A,139,387,0.359173126615
2181,NEWTON,552,City Pond,310,862,0.359628770302
1582,GLYNN,907,Howard Coffin Park,510,1417,0.359915314044
1610,GREENE,1254,Greensboro,707,1961,0.360530341662
1469,FULTON,383,SC04,216,599,0.360601001669
603,COBB,1633,Powder Springs 1A,925,2558,0.361610633307
2393,SCREVEN,434,Sr Citizens Center,247,681,0.362701908957
807,DEKALB,631,CHAMBLEE ,361,992,0.363911290323
2342,RICHMOND,1265,605,724,1989,0.364002011061
2057,MACON,531,Marshallville,304,835,0.364071856287
2179,MUSCOGEE,1085,EDGEWOOD BAPTIST,623,1708,0.364754098361
793,DEKALB,1193,BRIARCLIFF,686,1879,0.365087812666
2,APPLING,742,2,427,1169,0.365269461078
1659,GWINNETT,2056,BAYCREEK B,1184,3240,0.365432098765
420,CLARKE,1220,7B Alps Elem. School,704,1924,0.365904365904
1889,HENRY,1734,FLIPPEN,1002,2736,0.366228070175
318,CHATHAM,1341,6-11 Bamboo Farms,776,2117,0.366556447803
748,CRAWFORD,376,1B - COUNTY,218,594,0.367003367003
2290,RANDOLPH,734,Cuthbert/Courthouse,426,1160,0.36724137931
1451,FULTON,682,RW05,397,1079,0.367933271548
1515,FULTON,216,SS08C,126,342,0.368421052632
749,CRAWFORD,12,1B - CITY,7,19,0.368421052632
870,DEKALB,1391,LAKESIDE HIGH,812,2203,0.368588288697
1663,GWINNETT,1216,GARNERS B,711,1927,0.368967306694
1705,GWINNETT,999,PINCKNEYVILLE S,586,1585,0.369716088328
29,BALDWIN,303,City Hall Annex,178,481,0.370062370062
1695,GWINNETT,1751,GOODWINS C,1030,2781,0.37037037037
2056,MACON,487,Oglethorpe,287,774,0.370801033592
132,BROOKS,1362,Quitman,803,2165,0.370900692841
795,DEKALB,870,BRIARWOOD,513,1383,0.370932754881
532,COBB,738,Fair Oaks 04,436,1174,0.371379897785
277,CHATHAM,610,3-02 Rose of Sharon,361,971,0.371781668383
2444,TALBOT,464,FLINT HILL,275,739,0.372124492558
421,CLARKE,1070,7C Firestation #3,635,1705,0.372434017595
404,CLARKE,1192,1D Whit Davis School,710,1902,0.373291272345
17,ATKINSON,275,Pearson City,164,439,0.373576309795
1039,DOUGLAS,2337,CHURCH-CH,1396,3733,0.373961960889
416,CLARKE,1387,6B Ga Square Mall,829,2216,0.374097472924
2441,TALBOT,215,GENEVA,129,344,0.375
1545,FULTON,10,UC02B,6,16,0.375
1879,HENRY,1297,AUSTIN ROAD,780,2077,0.375541646606
796,DEKALB,966,BROCKETT,584,1550,0.376774193548
1774,GWINNETT,1566,BAYCREEK J,949,2515,0.377335984095
751,CRAWFORD,100,2 - CITY,61,161,0.378881987578
1047,EARLY,1270,Blakely,777,2047,0.379579872985
2030,LINCOLN,335,Lincoln Club House,205,540,0.37962962963
618,COBB,2241,Smyrna 3A,1373,3614,0.379911455451
2018,LIBERTY,1242,Lewis Frasier School,767,2009,0.381781981085
822,DEKALB,782,CROSS KEYS HIGH,483,1265,0.381818181818
2678,WORTH,903,Sylvester,559,1462,0.382352941176
633,COBB,1598,Vinings 03,991,2589,0.382773271533
503,COBB,899,Birney 01,558,1457,0.382978723404
2446,TALIAFERRO,431,Crawfordville,269,700,0.384285714286
2073,MARION,962,Buena Vista,602,1564,0.384910485934
1516,FULTON,407,SS08D,255,662,0.385196374622
1752,GWINNETT,1561,BAYCREEK F,981,2542,0.385916601101
1873,HENRY,1902,HICKORY FLAT,1197,3099,0.386253630203
1970,JONES,1127,HAWKINS,710,1837,0.386499727817
1121,FAYETTE,1206,SANDY CREEK-03,764,1970,0.387817258883
1675,GWINNETT,1378,DULUTH D,874,2252,0.38809946714
2423,STEWART,547,Richland,347,894,0.388143176734
2662,WILKES,564,Senior Citizen Center,358,922,0.388286334056
1035,DOUGLAS,970,ARBOR STATION,616,1586,0.388398486759
313,CHATHAM,608,6-05 Windsor Golden Age,387,995,0.388944723618
2424,STEWART,124,Louvale,79,203,0.389162561576
310,CHATHAM,585,6-01 White Bluff Pres Chr,373,958,0.389352818372
1300,FULTON,382,08K,244,626,0.389776357827
504,COBB,1441,Birney 02,922,2363,0.390181972069
419,CLARKE,1077,7A Timothy Road School,692,1769,0.391181458451
833,DEKALB,787,EMBRY HILLS,508,1295,0.392277992278
545,COBB,1899,Kennesaw 3A,1227,3126,0.392514395393
2425,STEWART,470,Lumpkin,304,774,0.392764857881
1519,FULTON,1289,SS11A,840,2129,0.394551432597
847,DEKALB,1303,GEORGETOWN SQUARE,851,2154,0.395078922934
1719,GWINNETT,700,PINCKNEYVILLE U,459,1159,0.39603106126
2176,MUSCOGEE,67,EPWORTH-02,44,111,0.396396396396
2306,RICHMOND,268,112,176,444,0.396396396396
1651,GWINNETT,621,BERKSHIRE F,408,1029,0.396501457726
679,COLUMBIA,286,Second Mt Carmel Bapt Church,188,474,0.396624472574
1466,FULTON,1361,RW22A,895,2256,0.396719858156
718,COOK,295,Sparks,194,489,0.39672801636
2081,MCDUFFIE,722,Vanderhorst,477,1199,0.397831526272
401,CLARKE,931,1A W'ville Train Depot,618,1549,0.398967075533
1032,DOUGLAS,1615,OLD COURTHOUSE,1075,2690,0.399628252788
1955,JEFFERSON,1441,Louisville,960,2401,0.399833402749
723,COWETA,1043,NEWNAN,696,1739,0.400230017251
1311,FULTON,1371,09F,919,2290,0.401310043668
512,COBB,666,Clarkdale 01,448,1114,0.402154398564
1441,FULTON,996,ML06B,670,1666,0.402160864346
1708,GWINNETT,1069,LAWRENCEVILLE I,721,1790,0.402793296089
829,DEKALB,1069,DUNWOODY,722,1791,0.403126744835
2322,RICHMOND,1272,306,861,2133,0.403656821378
495,COBB,1532,Acworth 1C,1037,2569,0.403659011288
2371,ROCKDALE,1176,Hightower,797,1973,0.403953370502
1581,GLYNN,720,College Place,488,1208,0.403973509934
327,CHATHAM,1067,7-10 Progressive Rec Ctr,724,1791,0.404243439419
1462,FULTON,924,RW17,627,1551,0.404255319149
1536,FULTON,884,SS22,600,1484,0.404312668464
631,COBB,859,Vinings 01,584,1443,0.404712404712
783,DEKALB,1400,ASHFORD PARKSIDE,954,2354,0.405267629567
1870,HENRY,656,MCDONOUGH,448,1104,0.405797101449
1422,FULTON,278,JC15,190,468,0.405982905983
1539,FULTON,917,SS29A,631,1548,0.407622739018
794,DEKALB,706,BRIARLAKE ELEM,486,1192,0.407718120805
1732,GWINNETT,1243,PINCKNEYVILLE W,856,2099,0.407813244402
2532,TWIGGS,630,GOLDEN ISLES,434,1064,0.407894736842
2238,PEACH,884,FORT VALLEY #1,610,1494,0.408299866131
1408,FULTON,527,JC03B,364,891,0.408529741863
189,CALHOUN,228,Edison-Arlington,159,389,0.408740359897
1738,GWINNETT,408,BERKSHIRE P,284,692,0.410404624277
2445,TALIAFERRO,114,Sharon,80,194,0.412371134021
2126,MONROE,1486,FORSYTH,1043,2529,0.412415974694
1647,GWINNETT,960,CATES C,677,1637,0.413561392792
1960,JENKINS,335,Jenkins Co Prim/Elem,237,572,0.414335664336
808,DEKALB,969,CHAMBLEE 2,686,1655,0.414501510574
1892,HENRY,1340,LIGHTHOUSE,950,2290,0.414847161572
1717,GWINNETT,918,PINCKNEYVILLE T,651,1569,0.414913957935
1405,FULTON,1737,JC01,1238,2975,0.416134453782
180,BURKE,209,Blakeney,149,358,0.416201117318
1579,GLYNN,964,Northside Church,688,1652,0.416464891041
572,COBB,2095,Marietta 3A,1499,3594,0.417084028937
571,COBB,1491,Marietta 2B,1069,2560,0.417578125
170,BURKE,127,Keysville,92,219,0.420091324201
1142,FAYETTE,983,JEFF DAVIS,713,1696,0.420400943396
2139,MORGAN,1025,Northeast Morgan,744,1769,0.420576596947
260,CHATHAM,214,1-09 Immanuel Bapt Church,156,370,0.421621621622
2416,SPALDING,836,GARY REID,610,1446,0.421853388658
1286,FULTON,1027,07F,751,1778,0.422384701912
2598,WASHINGTON,876,TENNILLE,641,1517,0.422544495715
276,CHATHAM,168,3-01 Old Courthouse,123,291,0.422680412371
2585,WARE,262,200B,192,454,0.422907488987
256,CHATHAM,1235,1-01 First Presbyterian Church,908,2143,0.423705086328
1698,GWINNETT,2112,BAYCREEK C,1558,3670,0.424523160763
1860,HENRY,1849,LOCUST GROVE,1368,3217,0.425240907678
312,CHATHAM,870,6-03 Crusader Comm Ctr,645,1515,0.425742574257
1864,HENRY,2763,LOWES,2051,4814,0.426049023681
1371,FULTON,292,AP09B,217,509,0.426326129666
2438,TALBOT,230,ONEAL,171,401,0.426433915212
1761,GWINNETT,1589,LAWRENCEVILLE L,1183,2772,0.426767676768
2357,RICHMOND,597,804,445,1042,0.427063339731
1765,GWINNETT,1793,BAYCREEK I,1337,3130,0.427156549521
994,DOUGHERTY,968,Sherwood Elem School,723,1691,0.42755765819
1580,GLYNN,757,Abundant Life,566,1323,0.427815570673
1437,FULTON,16,ML05A,12,28,0.428571428571
1051,EARLY,213,Damascus,160,373,0.428954423592
1636,GWINNETT,812,MARTINS C,610,1422,0.428973277075
1297,FULTON,847,08G,637,1484,0.429245283019
1415,FULTON,1001,JC09,755,1756,0.429954441913
2595,WARREN,1313,Warrenton,991,2304,0.430121527778
621,COBB,2161,Smyrna 6A,1635,3796,0.43071654373
186,CALHOUN,274,Leary,212,491,0.431771894094
31,BALDWIN,167,Courthouse,127,294,0.431972789116
257,CHATHAM,734,1-05 JEA Building,559,1293,0.432327919567
588,COBB,1410,Norton Park 01,1074,2484,0.432367149758
527,COBB,928,Elizabeth 04,709,1637,0.433109346365
2515,TROUP,1260,HAMMETT RD,965,2225,0.433707865169
1416,FULTON,757,JC10,581,1338,0.43423019432
956,DEKALB,1134,TUCKER,871,2005,0.434413965087
171,BURKE,152,Midville,117,269,0.434944237918
876,DEKALB,589,LIVSEY ELEM,454,1043,0.435282837967
1361,FULTON,271,AP01D,209,480,0.435416666667
167,BURKE,247,Girard,191,438,0.436073059361
1284,FULTON,1211,07D,937,2148,0.436219739292
2350,RICHMOND,632,707,490,1122,0.436720142602
1287,FULTON,719,07H,558,1277,0.436961628818
938,DEKALB,663,SKYLAND,515,1178,0.437181663837
858,DEKALB,722,HUGH HOWELL,561,1283,0.437256430242
428,CLAY,162,Old Head Start,126,288,0.4375
1504,FULTON,378,SS02A,294,672,0.4375
1623,GWINNETT,1206,GOODWINS A,938,2144,0.4375
417,CLARKE,1071,6C Timothy Road School,837,1908,0.438679245283
1525,FULTON,289,SS13B,226,515,0.438834951456
626,COBB,1147,Sweetwater 01,897,2044,0.438845401174
230,CARROLL,891,UNIVERSITY OF W. GA (714A4),700,1591,0.43997485858
590,COBB,1378,Oakdale 01,1083,2461,0.440065014222
2672,WILKINSON,301,Irwinton,237,538,0.440520446097
316,CHATHAM,1187,6-09 Trinity Lutheran Ch,935,2122,0.440622054665
2602,WASHINGTON,2188,SANDERSVILLE,1732,3920,0.441836734694
2571,WALTON,1223,North Monroe,971,2194,0.44257064722
1359,FULTON,239,AP01B,190,429,0.44289044289
1410,FULTON,88,JC04B,70,158,0.443037974684
1961,JENKINS,340,Court House,271,611,0.443535188216
1699,GWINNETT,1338,CATES L,1072,2410,0.444813278008
328,CHATHAM,1068,7-11 Seventh Day Adv Chr,858,1926,0.445482866044
1763,GWINNETT,1632,BAYCREEK G,1315,2947,0.446216491347
2535,TWIGGS,304,SHADY GROVE/TARVERS,245,549,0.446265938069
1954,JEFFERSON,942,Wrens,760,1702,0.446533490012
285,CHATHAM,552,3-12 Thunderbolt Muni. Complex,447,999,0.447447447447
1449,FULTON,1381,RW03,1122,2503,0.448262085497
1141,FAYETTE,777,OAK RIDGE,635,1412,0.449716713881
1281,FULTON,1989,07A,1633,3622,0.450855880729
1614,GREENE,360,Siloam,296,656,0.451219512195
1687,GWINNETT,1102,CATES J,908,2010,0.451741293532
248,CHARLTON,780,Folkston,644,1424,0.452247191011
2391,SCREVEN,134,Screven Rec Dept,111,245,0.45306122449
2020,LIBERTY,193,Button Gwinnett,160,353,0.453257790368
781,DEKALB,1081,ASHFORD DUNWOODY RD,897,1978,0.453488372093
322,CHATHAM,328,7-05 Woodlawn Bapt Ch,273,601,0.454242928453
1118,FAYETTE,731,HOPEFUL,612,1343,0.455696202532
1299,FULTON,968,08J,811,1779,0.455874086565
939,DEKALB,809,SMOKE RISE ELEM,678,1487,0.455951580363
2365,ROCKDALE,1656,Barksdale,1396,3052,0.457404980341
2189,NEWTON,743,Cedar Shoals,628,1371,0.458059810357
2324,RICHMOND,181,308,153,334,0.458083832335
1119,FAYETTE,1087,MORNING CREEK,919,2006,0.458125623131
798,DEKALB,1164,BROOKHAVEN,988,2152,0.459107806691
2405,SPALDING,974,UGA CAMPUS,830,1804,0.460088691796
2023,LIBERTY,1220,Liberty County,1040,2260,0.46017699115
2528,TURNER,1078,Ashburn,919,1997,0.460190285428
2512,TREUTLEN,716,Soperton,611,1327,0.460437076112
937,DEKALB,1560,SILVER LAKE,1332,2892,0.460580912863
1042,DOUGLAS,1404,LUTHERAN CHURCH - GS,1199,2603,0.460622358817
619,COBB,2065,Smyrna 4A,1765,3830,0.460835509138
997,DOUGHERTY,1185,Westover High School,1019,2204,0.462341197822
1866,HENRY,2052,NORTH HAMPTON,1766,3818,0.462545835516
502,COBB,1460,Baker 01,1257,2717,0.462642620537
1632,GWINNETT,1025,LAWRENCEVILLE A,884,1909,0.463069669984
1913,HOUSTON,1491,TMS,1287,2778,0.463282937365
1658,GWINNETT,1341,PINCKNEYVILLE H,1158,2499,0.463385354142
896,DEKALB,850,MONTGOMERY ELEM,736,1586,0.464060529634
869,DEKALB,782,KITTREDGE ELEM,678,1460,0.464383561644
1771,GWINNETT,647,LAWRENCEVILLE N,562,1209,0.464846980976
1643,GWINNETT,1345,HOG MOUNTAIN A,1172,2517,0.465633690902
2046,LOWNDES,6982,Northside,6085,13067,0.465676895998
511,COBB,1468,Chalker 01,1282,2750,0.466181818182
25,BAKER,105,Hoggard Mill,92,197,0.467005076142
2439,TALBOT,277,VALLEY,243,520,0.467307692308
1117,FAYETTE,560,FLINT,492,1052,0.467680608365
2347,RICHMOND,1319,703,1160,2479,0.467930617184
615,COBB,1372,Sewell Mill 03,1208,2580,0.468217054264
151,BULLOCH,1678,Statesboro,1479,3157,0.468482736775
1511,FULTON,161,SS07B,142,303,0.468646864686
1413,FULTON,1300,JC07,1147,2447,0.46873722926
595,COBB,1277,Oregon 05,1128,2405,0.469022869023
2387,SCREVEN,366,Jenk Hill Fire Sta,324,690,0.469565217391
1304,FULTON,393,08N2,349,742,0.470350404313
1283,FULTON,1072,07C,952,2024,0.470355731225
1624,GWINNETT,1462,DULUTH A,1301,2763,0.47086500181
1691,GWINNETT,664,PINCKNEYVILLE P,591,1255,0.470916334661
1506,FULTON,464,SS03,414,878,0.4715261959
415,CLARKE,947,6A Cleveland Rd School,845,1792,0.471540178571
674,COLUMBIA,599,Grovetown Methodist Church,536,1135,0.472246696035
1030,DOUGLAS,819,DEER LICK,733,1552,0.472293814433
1411,FULTON,705,JC05,634,1339,0.473487677371
1674,GWINNETT,691,DULUTH C,622,1313,0.473724295506
1886,HENRY,1693,PATES CREEK,1527,3220,0.474223602484
134,BROOKS,346,Dixie,313,659,0.474962063733
1406,FULTON,668,JC02,606,1274,0.475667189953
758,CRISP,2581,Cordele,2342,4923,0.475726183222
2676,WILKINSON,628,Ramah,570,1198,0.475792988314
1022,DOUGLAS,554,WINSTON,503,1057,0.475875118259
566,COBB,1102,McEachern 01,1002,2104,0.476235741445
677,COLUMBIA,701,Warren Baptist Church - Grovetown,638,1339,0.476474981329
1540,FULTON,349,SS31,318,667,0.47676161919
989,DOOLY,232,BYROMVILLE,212,444,0.477477477477
2373,ROCKDALE,1350,Lorraine,1239,2589,0.478563151796
561,COBB,903,Mableton 03,829,1732,0.478637413395
181,BUTTS,1225,BUTTS CO COMM CENTER,1130,2355,0.47983014862
2096,MERIWETHER,607,GREENVILLE,561,1168,0.480308219178
988,DOOLY,172,LILLY,159,331,0.480362537764
176,BURKE,138,St. Clair,128,266,0.481203007519
1667,GWINNETT,593,GARNERS C,551,1144,0.481643356643
1445,FULTON,157,MP01,146,303,0.481848184818
1613,GREENE,386,Union Point,359,745,0.481879194631
24,BAKER,133,Elmodel,124,257,0.482490272374
1716,GWINNETT,903,GOODWINS F,843,1746,0.482817869416
1813,HANCOCK,292,Devereux Fire Station,273,565,0.483185840708
1897,HENRY,1223,MCDONOUGH CENTRAL,1144,2367,0.483312209548
778,DECATUR,916,Bridge-Fairgrounds,857,1773,0.483361534123
1957,JEFFERSON,173,Bartow,162,335,0.483582089552
1373,FULTON,663,AP022,622,1285,0.484046692607
2097,MERIWETHER,365,LONE OAK,343,708,0.484463276836
177,BURKE,101,Vidette,95,196,0.484693877551
1653,GWINNETT,190,035 Cates D - 04,179,369,0.485094850949
1876,HENRY,988,STAGECOACH,933,1921,0.485684539302
529,COBB,733,East Piedmont 01,694,1427,0.486334968465
2186,NEWTON,803,Covington Mills,762,1565,0.486900958466
2426,STEWART,79,Omaha,75,154,0.487012987013
1523,FULTON,800,SS12,763,1563,0.488163787588
1620,GWINNETT,1363,DACULA,1300,2663,0.488171235449
1012,DOUGHERTY,810,Putney 1st Bapt Church,773,1583,0.488313329122
966,DEKALB,509,WINTERS CHAPEL,486,995,0.488442211055
2038,LONG,245,South Ludowici,234,479,0.488517745303
1512,FULTON,187,SS07C,179,366,0.489071038251
990,DOOLY,516,UNADILLA,494,1010,0.489108910891
1524,FULTON,467,SS13A,449,916,0.490174672489
106,BIBB,1166,HAZZARD 2,1123,2289,0.490607252075
1115,FAYETTE,634,FAYETTEVILLE EAST,611,1245,0.490763052209
1046,EARLY,138,Arlington,133,271,0.490774907749
197,CAMDEN,648,North Kingsland,625,1273,0.490966221524
2296,RICHMOND,262,101,253,515,0.491262135922
746,COWETA,2096,JEFFERSON PARKWAY,2025,4121,0.491385586023
2116,MITCHELL,907,Pelham,879,1786,0.492161254199
1452,FULTON,889,RW06,864,1753,0.4928693668
888,DEKALB,724,MIDVALE ELEM,704,1428,0.49299719888
676,COLUMBIA,713,Grovetown Middle School,695,1408,0.493607954545
88,BEN HILL,1114,East,1088,2202,0.494096276113
1043,DOUGLAS,822,FIRST BAPTIST CHURCH,803,1625,0.494153846154
1027,DOUGLAS,1085,TURNER,1060,2145,0.494172494172
1148,FAYETTE,1028,SPRING HILL,1005,2033,0.494343334973
1746,GWINNETT,812,GOODWINS H,794,1606,0.494396014944
1639,GWINNETT,622,PINCKNEYVILLE C,611,1233,0.495539334955
1409,FULTON,1267,JC04A,1245,2512,0.495621019108
991,DOOLY,839,VIENNA,828,1667,0.496700659868
2022,LIBERTY,471,Hinesville,465,936,0.496794871795
1739,GWINNETT,1026,PINCKNEYVILLE X,1013,2039,0.496812162825
2280,PUTNAM,1003,104,991,1994,0.496990972919
579,COBB,924,Marietta 6B,913,1837,0.497005988024
2308,RICHMOND,100,115,99,199,0.497487437186
1425,FULTON,1186,JC19,1177,2363,0.498095641134
1458,FULTON,792,RW11A,786,1578,0.498098859316
175,BURKE,281,Telfair,279,560,0.498214285714
2200,NEWTON,1365,Buck Creek,1357,2722,0.498530492285
1514,FULTON,196,SS08B,195,391,0.498721227621
2101,MERIWETHER,420,WOODBURY,418,838,0.498806682578
2382,ROCKDALE,1015,Stanton,1012,2027,0.499259990133
1298,FULTON,771,08H,771,1542,0.5
1729,GWINNETT,778,DULUTH H,779,1557,0.500321130379
1077,ELBERT,1144,Elberton,1146,2290,0.500436681223
2526,TROUP,456,HIGHLAND,457,913,0.500547645126
317,CHATHAM,1187,6-10 Georgetown Elem,1190,2377,0.500631047539
1701,GWINNETT,1157,GOODWINS D,1161,2318,0.50086281277
115,BIBB,457,HOWARD 5,459,916,0.501091703057
442,CLAYTON,836,JONESBORO 6,840,1676,0.501193317422
2006,LEE,162,Chokee,163,325,0.501538461538
1686,GWINNETT,1102,CATES I,1109,2211,0.50158299412
2198,NEWTON,138,Rocky Plains-4,140,278,0.503597122302
574,COBB,614,Marietta 4B,623,1237,0.503637833468
326,CHATHAM,614,7-09 Southwest Baptist Ch,625,1239,0.504439063761
1715,GWINNETT,1468,GOODWINS E,1500,2968,0.50539083558
1943,JEFF DAVIS,366,Hazelhurst,374,740,0.505405405405
154,BULLOCH,1462,Church,1495,2957,0.505579979709
1615,GREENE,122,White Plains,125,247,0.506072874494
2000,LAURENS,120,Harvard,123,243,0.506172839506
1907,HOUSTON,1863,HHPC,1912,3775,0.506490066225
2436,SUMTER,339,Plains,348,687,0.506550218341
1612,GREENE,184,Woodville,189,373,0.506702412869
1407,FULTON,179,JC03A,184,363,0.506887052342
1291,FULTON,864,08A,889,1753,0.5071306332
1726,GWINNETT,869,BAYCREEK E,895,1764,0.507369614512
5,APPLING,98,3B,101,199,0.507537688442
1370,FULTON,1232,AP09A,1272,2504,0.507987220447
782,DEKALB,782,ASHFORD PARK ELEM,809,1591,0.508485229415
1508,FULTON,606,SS05,627,1233,0.508515815085
635,COBB,1361,Wade Green 02,1410,2771,0.508841573439
899,DEKALB,761,MT. VERNON WEST,792,1553,0.50998068255
1696,GWINNETT,1109,BAYCREEK K,1156,2265,0.510375275938
288,CHATHAM,253,3-15 Eli Whitney Complex,264,517,0.510638297872
1021,DOUGLAS,1692,MIRROR LAKE ELEMENTA,1768,3460,0.51098265896
547,COBB,1708,Kennesaw 5A,1788,3496,0.511441647597
2312,RICHMOND,430,204,452,882,0.512471655329
2302,RICHMOND,532,107,560,1092,0.512820512821
543,COBB,652,Kennesaw 1A,688,1340,0.513432835821
2352,RICHMOND,160,709,169,329,0.51367781155
1877,HENRY,1243,COTTON INDIAN,1315,2558,0.514073494918
1071,EFFINGHAM,195,4B-1,207,402,0.514925373134
1176,FORSYTH,1744,02 Brandywine,1852,3596,0.515016685206
1792,HALL,1133,11-Tadmore,1205,2338,0.515397775877
1621,GWINNETT,435,SUWANEE A,464,899,0.516129032258
1378,FULTON,799,AP13,856,1655,0.517220543807
1168,FLOYD,843,NORTH ROME,905,1748,0.517734553776
329,CHATHAM,1515,7-12 Pooler Church,1630,3145,0.518282988871
1530,FULTON,1012,SS17,1096,2108,0.519924098672
673,COLUMBIA,812,Grovetown City Hall,881,1693,0.520378027171
2480,THOMAS,246,Meigs,267,513,0.520467836257
711,COOK,455,Cecil,494,949,0.520547945205
518,COBB,973,Dowell 01,1059,2032,0.521161417323
2471,THOMAS,495,Boston,539,1034,0.521276595745
624,COBB,1355,Sope Creek 02,1486,2841,0.523055262232
2110,MITCHELL,990,Camilla South,1086,2076,0.523121387283
1450,FULTON,581,RW04,639,1220,0.523770491803
1414,FULTON,830,JC08,913,1743,0.52380952381
314,CHATHAM,360,6-06 The Light,398,758,0.525065963061
1995,LAURENS,294,Burgamy,326,620,0.525806451613
1531,FULTON,209,SS18A,232,441,0.526077097506
1760,GWINNETT,1053,SUWANEE F,1171,2224,0.526528776978
1649,GWINNETT,833,BERKSHIRE D,927,1760,0.526704545455
2390,SCREVEN,265,Hiltonia,295,560,0.526785714286
2674,WILKINSON,228,Lord,254,482,0.526970954357
1804,HALL,948,23-Gainesville III,1059,2007,0.527653213752
1736,GWINNETT,465,GARNERS F,520,985,0.527918781726
2128,MONROE,209,KELSEYS,234,443,0.528216704289
2466,TERRELL,258,Bronwood,290,548,0.529197080292
1773,GWINNETT,980,SUWANEE G,1103,2083,0.529524723956
38,BALDWIN,539,West Baldwin,608,1147,0.530078465562
1439,FULTON,1169,ML05C,1320,2489,0.530333467256
1368,FULTON,902,AP07A,1019,1921,0.53045288912
33,BALDWIN,669,North Milledgeville,756,1425,0.530526315789
1372,FULTON,830,AP021,938,1768,0.530542986425
2174,MUSCOGEE,816,SALVATION ARMY,923,1739,0.530764807361
747,CRAWFORD,135,1A,153,288,0.53125
1993,LAURENS,290,Buckeye,329,619,0.531502423263
2428,SUMTER,199,Thomson,226,425,0.531764705882
125,BIBB,825,VINEVILLE 6,937,1762,0.531782065834
1383,FULTON,175,CH04A,199,374,0.532085561497
1122,FAYETTE,414,SANDY CREEK-13,472,886,0.532731376975
1423,FULTON,761,JC16,868,1629,0.5328422345
507,COBB,767,Blackwell 01,875,1642,0.532886723508
1167,FLOYD,1019,EAST ROME,1164,2183,0.533211177279
1819,HANCOCK,77,Warren Chapel,88,165,0.533333333333
597,COBB,959,Powers Ferry 01,1098,2057,0.533787068546
562,COBB,468,Mableton 04,536,1004,0.533864541833
1670,GWINNETT,691,BERKSHIRE G,792,1483,0.534052596089
2633,WHITFIELD,471,AN,540,1011,0.53412462908
1685,GWINNETT,1321,PUCKETTS E,1516,2837,0.53436728939
1509,FULTON,423,SS06,486,909,0.534653465347
1865,HENRY,1392,SOUTH HAMPTON,1600,2992,0.534759358289
2601,WASHINGTON,265,DAVISBORO,305,570,0.535087719298
2650,WHITFIELD,493,1A,568,1061,0.53534401508
546,COBB,1002,Kennesaw 4A,1155,2157,0.535465924896
27,BAKER,306,Newton,353,659,0.535660091047
2615,WAYNE,279,Pine Street,322,601,0.535773710483
995,DOUGHERTY,596,Covenant Pres Church,688,1284,0.535825545171
2599,WASHINGTON,174,OCONEE,201,375,0.536
2107,MITCHELL,293,Baconton,339,632,0.536392405063
830,DEKALB,662,DUNWOODY HIGH,766,1428,0.536414565826
2279,PUTNAM,856,101,991,1847,0.536545749865
1379,FULTON,873,AP14,1014,1887,0.537360890302
2169,MUSCOGEE,1382,GENTIAN/REESE @LDS,1607,2989,0.537638006022
2191,NEWTON,1619,Downs,1883,3502,0.537692747002
1654,GWINNETT,867,CATES E,1009,1876,0.537846481876
1448,FULTON,1170,RW02,1363,2533,0.538097118042
165,BURKE,120,Alexander,140,260,0.538461538462
776,DECATUR,583,West Bainbridge,683,1266,0.539494470774
1092,EMANUEL,145,Stillmore,170,315,0.539682539683
1666,GWINNETT,865,DULUTH B,1016,1881,0.540138224349
1518,FULTON,1007,SS09B,1188,2195,0.541230068337
1887,HENRY,1201,OAKLAND,1421,2622,0.541952707857
1750,GWINNETT,882,LAWRENCEVILLE K,1049,1931,0.543241843604
1650,GWINNETT,596,BERKSHIRE E,710,1306,0.543644716692
222,CARROLL,1400,VILLA RICA CITY (642),1668,3068,0.543676662321
2340,RICHMOND,881,603,1050,1931,0.543759709995
2004,LAURENS,780,Smith,932,1712,0.544392523364
1460,FULTON,1009,RW13,1206,2215,0.544469525959
750,CRAWFORD,407,2 - COUNTY,487,894,0.544742729306
1464,FULTON,831,RW20,995,1826,0.544906900329
1365,FULTON,131,AP04B,157,288,0.545138888889
1952,JEFFERSON,104,Stapleton Crossroads,125,229,0.545851528384
1362,FULTON,64,AP02B,77,141,0.54609929078
993,DOUGHERTY,635,Palmyra Rd Meth Church,765,1400,0.546428571429
996,DOUGHERTY,1215,Greenbriar Church,1467,2682,0.546979865772
2358,RICHMOND,769,804H,929,1698,0.547114252061
1295,FULTON,748,08E,904,1652,0.547215496368
2171,MUSCOGEE,411,ST PAUL U.M.C.-03,498,909,0.547854785479
954,DEKALB,482,TILLY MILL ROAD,587,1069,0.54911131899
1136,FAYETTE,488,BANKS,598,1086,0.550644567219
1767,GWINNETT,728,GOODWINS I,894,1622,0.551171393342
2460,TELFAIR,283,Lumber-City,348,631,0.551505546751
1709,GWINNETT,1254,BAYCREEK D,1543,2797,0.551662495531
1517,FULTON,857,SS09A,1056,1913,0.55201254574
2284,QUITMAN,426,Georgetown,525,951,0.552050473186
2033,LINCOLN,288,Tabernacle,355,643,0.552099533437
2055,MACON,397,Ideal,490,887,0.552423900789
611,COBB,849,Sandy Plains 01,1048,1897,0.552451238798
584,COBB,956,Mount Bethel 03,1181,2137,0.552643893308
1724,GWINNETT,1213,SUWANEE C,1502,2715,0.553222836096
2184,NEWTON,989,Alcovy-4,1228,2217,0.553901668922
1756,GWINNETT,1211,DULUTH I,1504,2715,0.553959484346
1652,GWINNETT,735,CATES D,913,1648,0.554004854369
2461,TELFAIR,612,McRae,761,1373,0.554260742899
528,COBB,860,Elizabeth 05,1071,1931,0.554634904195
734,COWETA,259,TURKEY CREEK,323,582,0.554982817869
1718,GWINNETT,1075,SUWANEE B,1349,2424,0.556518151815
345,CHATTAHOOCHEE,593,Chattahoochee Acvitity Center,746,1339,0.5571321882
1849,HART,306,Cokesbury,385,691,0.557163531114
634,COBB,1008,Vinings 04,1270,2278,0.557506584723
1360,FULTON,616,AP01C,777,1393,0.557788944724
493,COBB,1363,Acworth 1A,1721,3084,0.55804150454
1766,GWINNETT,464,BERKSHIRE Q,587,1051,0.558515699334
1529,FULTON,611,SS16,774,1385,0.558844765343
670,COLUMBIA,204,Harlem Baptist Church-12,259,463,0.55939524838
2036,LONG,305,Beards Creek,388,693,0.559884559885
1174,FLOYD,670,TOWN ROME,855,1525,0.560655737705
1714,GWINNETT,759,DULUTH G,969,1728,0.560763888889
2469,TERRELL,83,Herod-Dover,106,189,0.560846560847
1725,GWINNETT,381,CATES O,487,868,0.561059907834
1710,GWINNETT,800,BERKSHIRE J,1027,1827,0.562123700055
1116,FAYETTE,489,FAYETTEVILLE WEST,628,1117,0.562220232766
1532,FULTON,73,SS18B,94,167,0.562874251497
1292,FULTON,922,08B,1190,2112,0.563446969697
1905,HOUSTON,1487,HCTC,1924,3411,0.564057461155
2597,WASHINGTON,217,WARTHEN,281,498,0.564257028112
1461,FULTON,536,RW16,695,1231,0.564581640942
534,COBB,982,Fullers Park 01,1274,2256,0.564716312057
1302,FULTON,511,08M,663,1174,0.564735945486
1510,FULTON,225,SS07A,292,517,0.564796905222
35,BALDWIN,1011,East Baldwin,1313,2324,0.564974182444
2384,SCREVEN,318,Sylvania,413,731,0.564979480164
1679,GWINNETT,630,LAWRENCEVILLE E,819,1449,0.565217391304
1033,DOUGLAS,860,BEULAH,1119,1979,0.565437089439
614,COBB,976,Sewell Mill 01,1270,2246,0.565449688335
2227,PAULDING,1944,P B RITCH MIDD SCH,2531,4475,0.565586592179
1369,FULTON,430,AP07B,560,990,0.565656565657
1965,JOHNSON,872,Wrightsville,1136,2008,0.565737051793
629,COBB,767,Timber Ridge 01,1000,1767,0.565930956423
172,BURKE,72,Munnerlyn,94,166,0.566265060241
2008,LEE,268,Smithville,350,618,0.566343042071
200,CAMDEN,343,North St Marys,448,791,0.566371681416
1358,FULTON,533,AP01A,697,1230,0.566666666667
1727,GWINNETT,459,BERKSHIRE M,602,1061,0.567389255419
114,BIBB,446,HOWARD 4,585,1031,0.56741028128
498,COBB,792,Bells Ferry 02,1041,1833,0.567921440262
1377,FULTON,343,AP12C,451,794,0.568010075567
496,COBB,681,Addison 01,898,1579,0.568714376187
64,BARROW,577,10 Leisure Services Center,761,1338,0.568759342302
586,COBB,593,North Cobb 01,785,1378,0.569666182874
2159,MUSCOGEE,760,COLUMBUS TECH,1009,1769,0.570378745054
1703,GWINNETT,1070,LAWRENCEVILLE H,1421,2491,0.570453633079
179,BURKE,843,South Waynesboro,1120,1963,0.570555272542
500,COBB,667,Big Shanty 01,887,1554,0.570785070785
1282,FULTON,822,07B,1096,1918,0.571428571429
831,DEKALB,779,DUNWOODY LIBRARY,1039,1818,0.571507150715
2374,ROCKDALE,776,Magnet,1036,1812,0.57174392936
544,COBB,936,Kennesaw 2A,1250,2186,0.571820677036
1001,DOUGHERTY,390,Second Mt. Zion,521,911,0.571899012075
2098,MERIWETHER,639,LUTHERSVILLE,854,1493,0.572002679169
2619,WEBSTER,471,Preston 1,630,1101,0.572207084469
2362,RICHMOND,586,808,784,1370,0.572262773723
2230,PAULDING,1700,HIRAM HIGH SCHOOL,2275,3975,0.572327044025
1138,FAYETTE,784,WILLOW POND,1050,1834,0.572519083969
1622,GWINNETT,754,BAYCREEK A,1010,1764,0.572562358277
2550,UPSON,1975,TOWN,2651,4626,0.573065283182
1573,GLYNN,200,Jekyll Island,269,469,0.573560767591
2434,SUMTER,501,Airport,674,1175,0.573617021277
510,COBB,1117,Cheatham Hill 03,1507,2624,0.57431402439
323,CHATHAM,661,7-06 Pooler City Hall,894,1555,0.574919614148
2136,MONTGOMERY,368,Mount Vernon,498,866,0.575057736721
784,DEKALB,784,AUSTIN,1064,1848,0.575757575758
2432,SUMTER,774,GSW Conf Center,1051,1825,0.575890410959
2027,LIBERTY,495,Gum Branch,673,1168,0.576198630137
231,CARROLL,538,COUNTY ADMIN BLDG (714A5),732,1270,0.576377952756
2180,MUSCOGEE,1830,PSALMOND/MATHEWS,2497,4327,0.577074185348
898,DEKALB,765,MT. VERNON EAST,1048,1813,0.57804743519
259,CHATHAM,437,1-08 Grace United Meth Chur,599,1036,0.578185328185
2443,TALBOT,121,BOX SPRINGS,166,287,0.578397212544
1381,FULTON,129,CH02,177,306,0.578431372549
311,CHATHAM,666,6-02 Windsor Forest Baptist,914,1580,0.578481012658
1143,FAYETTE,883,MURPHY,1215,2098,0.579122974261
1599,GRADY,614,Cairo 5th District,845,1459,0.579163810829
1618,GWINNETT,1465,HARBINS A,2020,3485,0.57962697274
1163,FLOYD,1003,MT ALTO NORTH,1383,2386,0.579631181894
2657,WILCOX,112,Abbeville North 2,155,267,0.580524344569
998,DOUGHERTY,614,Merry Acres Middle,851,1465,0.580887372014
1522,FULTON,90,SS11D,125,215,0.581395348837
1417,FULTON,836,JC11,1162,1998,0.581581581582
516,COBB,823,Dickerson 01,1145,1968,0.581808943089
1537,FULTON,406,SS25,565,971,0.581874356334
610,COBB,1041,Roswell 02,1450,2491,0.582095543958
494,COBB,1152,Acworth 1B,1607,2759,0.582457412106
2173,MUSCOGEE,1833,ST. ANDREWS/MIDLAND,2561,4394,0.582840236686
228,CARROLL,370,EAST CARROLLTON REC (714A2),517,887,0.582863585118
2045,LOWNDES,1943,Trinity-008,2715,4658,0.58286818377
1424,FULTON,749,JC18,1047,1796,0.582962138085
109,BIBB,709,HAZZARD 5,999,1708,0.584894613583
258,CHATHAM,562,1-06 Central Chur of Christ,793,1355,0.585239852399
173,BURKE,238,Sardis,337,575,0.586086956522
2370,ROCKDALE,623,Honey Creek,883,1506,0.586321381142
733,COWETA,571,SMOKEY ROAD,811,1382,0.586830680174
1366,FULTON,1184,AP05,1685,2869,0.587312652492
583,COBB,1172,Mount Bethel 01,1668,2840,0.587323943662
1412,FULTON,647,JC06,922,1569,0.587635436584
113,BIBB,2169,HOWARD 3,3096,5265,0.588034188034
1783,HALL,496,02-Chicopee,708,1204,0.58803986711
1130,FAYETTE,899,KEDRON,1284,2183,0.588181401741
2285,QUITMAN,35,Morris,50,85,0.588235294118
1919,IRWIN,671,Ocilla,959,1630,0.588343558282
2457,TAYLOR,543,#6 REYNOLDS,777,1320,0.588636363636
2044,LOWNDES,381,Trinity-001,547,928,0.589439655172
1730,GWINNETT,834,BERKSHIRE N,1198,2032,0.589566929134
613,COBB,533,Simpson 01,766,1299,0.589684372594
867,DEKALB,724,KINGSLEY ELEM,1042,1766,0.590033975085
2199,NEWTON,676,Rocky Plains-10,976,1652,0.590799031477
1770,GWINNETT,1229,ROCKYCREEK C,1778,3007,0.591286997007
1421,FULTON,635,JC14,919,1554,0.591377091377
319,CHATHAM,317,7-01 Garden City Senior Ctr,460,777,0.592020592021
429,CLAY,117,Day's Cross Roads,170,287,0.592334494774
2658,WILCOX,165,Pineview 2,240,405,0.592592592593
1028,DOUGLAS,435,FIRST BAPTIST - LITHIA SPRINGS,633,1068,0.592696629213
2348,RICHMOND,624,705,909,1533,0.592954990215
2287,RANDOLPH,61,Coleman,89,150,0.593333333333
1055,EARLY,157,Lucille,230,387,0.594315245478
1296,FULTON,567,08F1,832,1399,0.594710507505
501,COBB,805,Big Shanty 02,1185,1990,0.595477386935
537,COBB,759,Garrison Mill 01,1119,1878,0.595846645367
1903,HOUSTON,2096,FMMS,3096,5192,0.596302003082
522,COBB,832,Eastside 01,1231,2063,0.596703829375
523,COBB,1115,Eastside 02,1651,2766,0.596890817064
1457,FULTON,844,RW10,1254,2098,0.597712106768
1737,GWINNETT,660,BERKSHIRE O,983,1643,0.598295800365
1645,GWINNETT,1296,ROCKYCREEK A,1931,3227,0.598388596219
1880,HENRY,854,SWAN LAKE,1273,2127,0.598495533615
1631,GWINNETT,886,GARNERS A,1321,2207,0.598550067966
1697,GWINNETT,623,CATES K,929,1552,0.598582474227
609,COBB,1534,Roswell 01,2292,3826,0.599059069524
541,COBB,1146,Hightower 01,1713,2859,0.599160545645
2095,MERIWETHER,76,ODESSADALE,114,190,0.6
1303,FULTON,199,08N1,299,498,0.600401606426
2231,PAULDING,2349,TAYLOR FARM PARK,3530,5879,0.600442252084
1754,GWINNETT,905,HOG MOUNTAIN C,1365,2270,0.601321585903
1878,HENRY,1044,PLEASANT GROVE,1577,2621,0.601678748569
1893,HENRY,667,DUTCHTOWN,1008,1675,0.601791044776
169,BURKE,240,Greenscut,363,603,0.601990049751
1367,FULTON,463,AP06,701,1164,0.602233676976
1526,FULTON,362,SS14,549,911,0.602634467618
2576,WALTON,694,E Monroe,1056,1750,0.603428571429
1688,GWINNETT,930,GOODWINS B,1418,2348,0.603918228279
143,BRYAN,337,Ways Station,514,851,0.603995299647
612,COBB,916,Shallowford Fall 01,1401,2317,0.604661199827
2668,WILKES,237,Tignall Sch Lunch RM,363,600,0.605
1503,FULTON,775,SS01,1188,1963,0.605196128375
538,COBB,960,Gritters 01,1472,2432,0.605263157895
1805,HALL,546,24-Gainesville IV,838,1384,0.60549132948
585,COBB,805,Mount Bethel 04,1237,2042,0.605778648384
110,BIBB,427,HOWARD 1,657,1084,0.606088560886
229,CARROLL,739,BONNER (714A3),1138,1877,0.606286627597
1426,FULTON,604,ML011,932,1536,0.606770833333
296,CHATHAM,446,4-11 Tybee Island School Cafe,690,1136,0.607394366197
1463,FULTON,524,RW19,811,1335,0.607490636704
193,CAMDEN,453,Woodbine,702,1155,0.607792207792
1442,FULTON,29,ML071,45,74,0.608108108108
499,COBB,1357,Bells Ferry 03,2108,3465,0.608369408369
1711,GWINNETT,1017,CATES M,1580,2597,0.608394301117
116,BIBB,523,HOWARD 6,813,1336,0.608532934132
565,COBB,1035,Murdock 01,1611,2646,0.608843537415
1459,FULTON,1529,RW12,2381,3910,0.60895140665
525,COBB,617,Elizabeth 02,961,1578,0.608998732573
1641,GWINNETT,791,SUGAR HILL A,1235,2026,0.609575518263
1755,GWINNETT,1147,ROCKYCREEK B,1801,2948,0.61092265943
2217,OCONEE,441,City Hall,693,1134,0.611111111111
1648,GWINNETT,703,HOG MOUNTAIN D,1105,1808,0.611172566372
526,COBB,723,Elizabeth 03,1138,1861,0.611499193982
669,COLUMBIA,219,Harlem Baptist Church-10,345,564,0.61170212766
2437,SUMTER,497,AG Center,784,1281,0.612021857923
2467,TERRELL,116,Parrott,183,299,0.612040133779
1896,HENRY,980,LAKE HAVEN,1547,2527,0.612188365651
1642,GWINNETT,1038,SUGAR HILL B,1639,2677,0.612252521479
1090,EMANUEL,1482,Swainsboro,2342,3824,0.612447698745
1723,GWINNETT,864,SUGAR HILL F,1372,2236,0.613595706619
582,COBB,646,Mars Hill 02,1027,1673,0.613867304244
2684,WORTH,71,Piney Woods,113,184,0.614130434783
2089,MCINTOSH,578,Darien,922,1500,0.614666666667
282,CHATHAM,171,3-09 Cokesbury Methodist,273,444,0.614864864865
777,DECATUR,1355,Bainbridge-Coliseum,2164,3519,0.614947428247
1941,JASPER,1067,MONTICELLO,1706,2773,0.615218175261
1019,DOUGHERTY,389,First Christian Church,622,1011,0.615232443126
2527,TROUP,619,NORTHSIDE,990,1609,0.615288999378
521,COBB,502,Davis 01,803,1305,0.615325670498
324,CHATHAM,1262,7-07 Rothwell Bapt Ch,2019,3281,0.615361170375
1465,FULTON,769,RW21,1231,2000,0.6155
2039,LONG,287,North Ludowici,460,747,0.615796519411
1164,FLOYD,828,MT ALTO SOUTH,1328,2156,0.615955473098
1067,EFFINGHAM,336,3B,540,876,0.616438356164
1744,GWINNETT,719,PINCKNEYVILLE A1,1156,1875,0.616533333333
2177,MUSCOGEE,758,EPWORTH-03,1222,1980,0.617171717172
164,BULLOCH,186,Register,300,486,0.617283950617
1644,GWINNETT,1093,HOG MOUNTAIN B,1763,2856,0.617296918768
1764,GWINNETT,1288,BAYCREEK H,2087,3375,0.61837037037
607,COBB,852,Rocky Mountain 01,1381,2233,0.618450515002
1294,FULTON,252,08D,409,661,0.618759455371
263,CHATHAM,293,1-13 The Sanctuary,476,769,0.618985695709
666,COLUMBIA,1078,Patriots Park,1753,2831,0.619215824797
1447,FULTON,1136,RW01,1860,2996,0.62082777036
219,CARROLL,807,BETHANY (501),1322,2129,0.620948802255
124,BIBB,555,VINEVILLE 5,910,1465,0.621160409556
1133,FAYETTE,490,FLAT CREEK,806,1296,0.621913580247
1364,FULTON,414,AP04A,681,1095,0.621917808219
2386,SCREVEN,233,Newington,384,617,0.622366288493
1707,GWINNETT,662,SUGAR HILL E,1092,1754,0.622576966933
2320,RICHMOND,100,304,165,265,0.622641509434
601,COBB,797,Pope 01,1316,2113,0.622811168954
648,COLQUITT,149,Doerun,248,397,0.624685138539
1680,GWINNETT,621,PINCKNEYVILLE L,1034,1655,0.624773413897
2099,MERIWETHER,321,ALVATON,535,856,0.625
2323,RICHMOND,392,307,654,1046,0.625239005736
232,CARROLL,320,TABERNACLE CHURCH (714A6),534,854,0.625292740047
636,COBB,750,Wileo 01,1254,2004,0.625748502994
1036,DOUGLAS,553,BRIGHT STAR,926,1479,0.626098715348
623,COBB,583,Sope Creek 01,977,1560,0.626282051282
1083,ELBERT,371,Pike,622,993,0.62638469285
519,COBB,553,Dodgen 01,929,1482,0.62685560054
550,COBB,978,Kemp 02,1643,2621,0.626859977108
606,COBB,647,Pitner 01,1087,1734,0.626874279123
1673,GWINNETT,834,SUGAR HILL D,1402,2236,0.627012522361
1971,JONES,418,ETHRIDGE,705,1123,0.627782724844
1041,DOUGLAS,466,ST JULIANS EPISCOPAL,788,1254,0.628389154705
644,COLQUITT,900,Moultrie,1522,2422,0.628406275805
2048,LOWNDES,95,Naylor-008,161,256,0.62890625
1914,HOUSTON,1057,TWPK,1793,2850,0.629122807018
2524,TROUP,440,GARDNER NEWMAN,747,1187,0.629317607414
625,COBB,721,Sope Creek 03,1225,1946,0.629496402878
567,COBB,442,McCleskey 01,752,1194,0.629815745394
144,BRYAN,510,RH Recreation,870,1380,0.630434782609
2085,MCDUFFIE,240,Whiteoak,410,650,0.630769230769
1981,LAMAR,300,SENIOR CITZEN BLDG,513,813,0.630996309963
1600,GRADY,118,Duncanville,202,320,0.63125
589,COBB,570,Nicholson 01,976,1546,0.631306597671
1660,GWINNETT,621,LAWRENCEVILLE C,1064,1685,0.631454005935
1749,GWINNETT,927,SUWANEE E,1593,2520,0.632142857143
201,CAMDEN,620,Mary Lee Clark,1070,1690,0.633136094675
2427,SUMTER,394,Leslie,680,1074,0.633147113594
1434,FULTON,402,ML04A,694,1096,0.633211678832
978,DODGE,979,Lee,1692,2671,0.633470610258
1681,GWINNETT,648,PINCKNEYVILLE M,1120,1768,0.633484162896
1837,HARRIS,368,GOODMAN,637,1005,0.633830845771
364,CHEROKEE,1068,BELLS,1849,2917,0.63387041481
2215,OCONEE,637,Athens Academy,1104,1741,0.634118322803
399,CHEROKEE,813,WOODLANDS,1411,2224,0.634442446043
685,COLUMBIA,766,Grace Baptist Church,1332,2098,0.634890371783
2479,THOMAS,459,Jerger,799,1258,0.635135135135
2639,WHITFIELD,465,GL,810,1275,0.635294117647
515,COBB,809,Chestnut Ridge 01,1410,2219,0.635421360973
2005,LAURENS,441,LCFS 10 (Valambrosia),769,1210,0.635537190083
2518,TROUP,622,HOGANSVILLE,1085,1707,0.635618043351
976,DODGE,51,Jaybird,89,140,0.635714285714
672,COLUMBIA,429,Philadelphia Church,749,1178,0.635823429542
118,BIBB,1313,RUTLAND 1,2296,3609,0.636187309504
1909,HOUSTON,467,MILL,817,1284,0.636292834891
1958,JEFFERSON,146,Stapleton,256,402,0.636815920398
688,COLUMBIA,415,Mtz Col Fire Dept #4,729,1144,0.637237762238
36,BALDWIN,218,Scottsboro,383,601,0.637271214642
34,BALDWIN,604,Meriweather,1063,1667,0.637672465507
1842,HARRIS,205,SKINNER,361,566,0.637809187279
2158,MUSCOGEE,1227,CORNERSTONE CHURCH,2169,3396,0.638692579505
570,COBB,536,Marietta 2A,948,1484,0.638814016173
1097,EMANUEL,322,Twin City,571,893,0.639417693169
602,COBB,587,Palmer 01,1042,1629,0.639656230816
2032,LINCOLN,117,Faith Temple of Linc,209,326,0.641104294479
1374,FULTON,225,AP10,402,627,0.641148325359
202,CAMDEN,436,South St Marys,779,1215,0.641152263374
1906,HOUSTON,280,HEFS,501,781,0.641485275288
1627,GWINNETT,520,CATES A,932,1452,0.641873278237
289,CHATHAM,484,4-02 Frank Murray Comm Ct,868,1352,0.64201183432
2226,PAULDING,1670,WATSON GOVT COMPLEX,2996,4666,0.64209172739
1743,GWINNETT,477,PINCKNEYVILLE Z,857,1334,0.642428785607
26,BAKER,74,Milford,133,207,0.642512077295
1017,DOUGHERTY,473,Christ Church,854,1327,0.643556895252
703,COLUMBIA,485,Church of our Savior,876,1361,0.643644379133
2379,ROCKDALE,483,Sheffield,874,1357,0.64406779661
696,COLUMBIA,392,Gospel Water Branch,712,1104,0.644927536232
370,CHEROKEE,1177,WOODSTOCK,2138,3315,0.644947209653
295,CHATHAM,359,4-10 Guard House Comm Ctr,653,1012,0.645256916996
548,COBB,461,Kell 01,840,1301,0.645657186779
1845,HARRIS,609,WAVERLY HALL,1112,1721,0.646135967461
2600,WASHINGTON,231,HARRISON,422,653,0.646248085758
699,COLUMBIA,268,Mtz Col Fire Hdqtr,491,759,0.646903820817
1646,GWINNETT,370,CATES B,678,1048,0.646946564885
1037,DOUGLAS,746,DORSETT SHOALS,1368,2114,0.647114474929
1901,HOUSTON,1515,CENT,2784,4299,0.647592463364
369,CHEROKEE,750,CARMEL,1384,2134,0.64854732896
2421,SPALDING,931,EAGES LANDING BAPTIST,1719,2650,0.648679245283
509,COBB,702,Cheatham Hill 02,1298,2000,0.649
2345,RICHMOND,565,701,1047,1612,0.649503722084
198,CAMDEN,376,Kingsland,699,1075,0.65023255814
158,BULLOCH,443,Hagin,824,1267,0.650355169692
2103,MERIWETHER,152,DURAND,283,435,0.650574712644
2487,THOMAS,466,Remington ESC,869,1335,0.650936329588
1759,GWINNETT,608,SUGAR HILL G,1134,1742,0.650975889782
2506,TOOMBS,712,514 S.T.I.A.L.C,1329,2041,0.651151396374
2364,RICHMOND,80,810,150,230,0.652173913043
148,BRYAN,392,Public Safety,737,1129,0.652790079717
1751,GWINNETT,893,HARBINS B,1682,2575,0.653203883495
637,COFFEE,3170,Douglas,5973,9143,0.653286667396
1455,FULTON,460,RW08,867,1327,0.653353428787
127,BIBB,705,WARRIOR 2,1330,2035,0.653562653563
264,CHATHAM,388,1-14 St Luke Church,733,1121,0.653880463872
2156,MUSCOGEE,483,BRITT DAVID BAPT CH,913,1396,0.654011461318
707,COLUMBIA,410,Col Cty Main Library,777,1187,0.654591406908
233,CARROLL,268,EMC (714BN),508,776,0.654639175258
139,BRYAN,449,Pembroke,852,1301,0.654880860876
1665,GWINNETT,641,CATES G,1217,1858,0.655005382131
16,ATKINSON,257,Willacoochee,488,745,0.655033557047
575,COBB,648,Marietta 4C,1231,1879,0.655135710484
2666,WILKES,124,Rayle City Hall,236,360,0.655555555556
2349,RICHMOND,735,706,1400,2135,0.655737704918
552,COBB,843,Lasssiter 01,1606,2449,0.655777868518
2170,MUSCOGEE,822,ST PAUL U.M.C.-02,1568,2390,0.656066945607
2205,OCONEE,498,Annex,950,1448,0.656077348066
737,COWETA,540,GREENTOP,1031,1571,0.656269891789
1190,FORSYTH,1343,19 Old Atlanta,2567,3910,0.65652173913
112,BIBB,747,HOWARD 2 - 08,1429,2176,0.656709558824
2123,MONROE,93,CULLODEN,178,271,0.656826568266
382,CHEROKEE,1456,LITTLE RIVER,2790,4246,0.657089024965
1753,GWINNETT,614,PUCKETTS C,1177,1791,0.657174762702
600,COBB,849,Post Oak 01,1629,2478,0.657384987893
1026,DOUGLAS,1153,PRAYS MILL GYM,2216,3369,0.657761947165
425,CLAY,78,Bluffton,150,228,0.657894736842
1910,HOUSTON,519,NSES,1001,1520,0.658552631579
1975,JONES,384,POPE,741,1125,0.658666666667
2490,TIFT,598,Tifton Northeast,1154,1752,0.658675799087
2344,RICHMOND,280,608,541,821,0.658952496955
2417,SPALDING,347,AMBUCS,671,1018,0.659135559921
1985,LANIER,610,Lakeland,1180,1790,0.659217877095
182,BUTTS,537,JENKINSBURG,1039,1576,0.659263959391
1908,HOUSTON,1718,MCMS,3325,5043,0.659329764029
2236,PEACH,946,BYRON #2,1831,2777,0.659344616493
701,COLUMBIA,349,Martinez Baptist,676,1025,0.659512195122
2451,TATTNALL,453,District II,878,1331,0.659654395192
1838,HARRIS,509,HAMILTON,987,1496,0.659759358289
1672,GWINNETT,982,SUGAR HILL C,1905,2887,0.659854520263
153,BULLOCH,1130,Fair,2198,3328,0.660456730769
236,CARROLL,224,NEW HOPE (716),436,660,0.660606060606
2521,TROUP,387,MOUNTVILLE,762,1149,0.66318537859
591,COBB,387,Oregon 01,762,1149,0.66318537859
343,CHATHAM,131,8-13 Savannah Christ. Sch,258,389,0.66323907455
1664,GWINNETT,399,CATES F,788,1187,0.663858466723
2346,RICHMOND,404,702,798,1202,0.663893510815
2360,RICHMOND,243,806,480,723,0.663900414938
2667,WILKES,234,Courthouse,463,697,0.664275466284
2385,SCREVEN,98,Hunters,194,292,0.664383561644
490,CLINCH,58,Dupont,115,173,0.664739884393
690,COLUMBIA,388,Marvin Methodist Church,770,1158,0.66493955095
2578,WALTON,696,Tara,1382,2078,0.665062560154
2637,WHITFIELD,267,ES,531,798,0.665413533835
1806,HALL,268,25-Gainesville V,535,803,0.666251556663
1456,FULTON,1276,RW09,2548,3824,0.666317991632
2468,TERRELL,129,Graves,258,387,0.666666666667
348,CHATTOOGA,53,COLDWATER,106,159,0.666666666667
1748,GWINNETT,942,SUWANEE D,1885,2827,0.66678457729
85,BARTOW,935,ZENA DRIVE,1871,2806,0.666785459729
2489,THOMAS,530,Scott,1062,1592,0.667085427136
1293,FULTON,282,08C,566,848,0.667452830189
1912,HOUSTON,2469,ROZR,4960,7429,0.667653789204
2429,SUMTER,218,Chambliss,438,656,0.667682926829
1149,FAYETTE,423,ANTIOCH,854,1277,0.668754894283
2691,WORTH,45,Oakfield,91,136,0.669117647059
2029,LINCOLN,110,Midway,223,333,0.66966966967
1140,FAYETTE,199,DOGWOOD-13,404,603,0.669983416252
563,COBB,392,Mabry 01,797,1189,0.67031118587
2216,OCONEE,925,Civic Center,1882,2807,0.670466690417
2289,RANDOLPH,84,Benevolence,171,255,0.670588235294
126,BIBB,554,WARRIOR 1,1130,1684,0.671021377672
138,BROOKS,368,Morven,754,1122,0.67201426025
334,CHATHAM,134,8-03 Silk Hope Bapt Ch,275,409,0.672371638142
330,CHATHAM,547,7-13 Garden City City Hall,1123,1670,0.67245508982
1784,HALL,389,03-Oakwood I,799,1188,0.672558922559
2458,TELFAIR,195,Helena,401,596,0.672818791946
2091,MCINTOSH,409,North Darien,842,1251,0.673061550759
2653,WHITFIELD,531,4A,1095,1626,0.673431734317
2102,MERIWETHER,252,WARM SPRINGS,520,772,0.673575129534
1601,GRADY,170,Higdon,352,522,0.674329501916
1418,FULTON,521,JC12,1079,1600,0.674375
1192,FORSYTH,1802,25 Windermere,3734,5536,0.674494219653
1844,HARRIS,152,VALLEY PLAINS,316,468,0.675213675214
1132,FAYETTE,225,WINDGATE,468,693,0.675324675325
2064,MADISON,112,Fork,233,345,0.675362318841
2093,MERIWETHER,299,MANCHESTER GILL I,623,922,0.675704989154
117,BIBB,566,HOWARD 7,1180,1746,0.675830469645
2472,THOMAS,654,Central,1365,2019,0.676077265973
1989,LAURENS,846,Family Life Center,1766,2612,0.676110260337
2620,WHEELER,398,Alamo,831,1229,0.676159479251
1964,JENKINS,191,Four Points,399,590,0.676271186441
1802,HALL,625,21-Gainesville I,1307,1932,0.676501035197
2317,RICHMOND,552,301,1157,1709,0.677004095963
1175,FORSYTH,3386,01 Big Creek,7099,10485,0.677062470196
1144,FAYETTE,788,FIELDING RIDGE,1655,2443,0.677445763406
1847,HART,1235,Hartwell,2596,3831,0.677629861655
1973,JONES,473,ROBERTS,995,1468,0.677792915531
2410,SPALDING,378,CARVER,796,1174,0.678023850085
2353,RICHMOND,94,801,198,292,0.678082191781
2596,WASHINGTON,135,RIDDLEVILLE,285,420,0.678571428571
2397,SEMINOLE,231,Precinct 2,489,720,0.679166666667
2079,MCDUFFIE,220,Fort Creek,466,686,0.679300291545
199,CAMDEN,978,East Kingsland,2072,3050,0.679344262295
2157,MUSCOGEE,626,ST PETER U. M. C.,1327,1953,0.679467485919
554,COBB,738,Lost Mountain 01,1567,2305,0.679826464208
73,BARTOW,1084,CARTERSVILLE EAST,2302,3386,0.679858239811
2465,TERRELL,286,Sasser,608,894,0.680089485459
1902,HOUSTON,854,CGTC,1816,2670,0.680149812734
1099,EVANS,1130,Veteran's Comm Ctr,2404,3534,0.680249009621
2652,WHITFIELD,399,3A,849,1248,0.680288461538
2172,MUSCOGEE,972,MOON/MORNINGSIDE,2076,3048,0.681102362205
61,BARROW,490,07 Statham Elementary School,1047,1537,0.68119713728
1895,HENRY,605,GROVE PARK,1295,1900,0.681578947368
2082,MCDUFFIE,610,Sweetwater Activity Center,1306,1916,0.681628392484
166,BURKE,385,Four Points,826,1211,0.682080924855
119,BIBB,640,RUTLAND 2,1374,2014,0.682224428997
299,CHATHAM,404,4-14 Skidaway Island Methodist Church,868,1272,0.682389937107
1953,JEFFERSON,125,Matthews,270,395,0.683544303797
2584,WARE,461,200A,997,1458,0.683813443073
300,CHATHAM,435,4-15 Skidaway Island State Park,942,1377,0.684095860566
556,COBB,1081,Lost Mountain 03,2342,3423,0.684195150453
2677,WILKINSON,93,Turkey Creek,202,295,0.684745762712
1128,FAYETTE,713,MCINTOSH,1549,2262,0.684792219275
2355,RICHMOND,512,802,1114,1626,0.685116851169
1428,FULTON,17,ML01B,37,54,0.685185185185
492,CLINCH,566,Homerville,1232,1798,0.685205784205
743,COWETA,473,NORTHSIDE,1031,1504,0.685505319149
536,COBB,511,Frey 01,1115,1626,0.685731857319
1891,HENRY,721,KELLEYTOWN,1576,2297,0.686112320418
1123,FAYETTE,314,SHAKERAG EAST,687,1001,0.686313686314
70,BARROW,935,16 The Church at Winder,2047,2982,0.686452045607
1159,FLOYD,371,GARDEN LAKES,814,1185,0.686919831224
2560,WALKER,246,FAIRYLAND,540,786,0.687022900763
1883,HENRY,424,UNITY GROVE - 03,935,1359,0.688005886681
2273,POLK,1051,CEDARTOWN,2318,3369,0.68803799347
2278,PULASKI,1104,COURTHOUSE ANNEX,2436,3540,0.68813559322
1720,GWINNETT,579,PUCKETTS B,1278,1857,0.688206785137
1382,FULTON,72,CH03,159,231,0.688311688312
400,CHEROKEE,1285,NEESE,2840,4125,0.688484848485
293,CHATHAM,629,4-07 Wilm Is Un Meth Ch,1394,2023,0.689075630252
1082,ELBERT,92,Moss-Ruckersville,204,296,0.689189189189
2214,OCONEE,821,Malcom Bridge,1821,2642,0.689250567752
557,COBB,558,Lost Mountain 04,1238,1796,0.689309576837
224,CARROLL,530,TEMPLE CITY (650),1179,1709,0.689877121123
727,COWETA,457,GRANTVILLE,1017,1474,0.689959294437
2037,LONG,332,Rye Patch/Oak Dale,739,1071,0.690009337068
205,CANDLER,620,Metter -1685,1381,2001,0.690154922539
374,CHEROKEE,962,DIXIE,2143,3105,0.690177133655
1888,HENRY,964,LAKE DOW,2148,3112,0.690231362468
1772,GWINNETT,612,PUCKETTS D,1368,1980,0.690909090909
2229,PAULDING,999,PAULDING CO HIGH SC,2235,3234,0.691094619666
2453,TATTNALL,459,District IV,1027,1486,0.691117092867
1572,GLYNN,860,First Baptist,1925,2785,0.691202872531
2448,TATTNALL,137,Shiloh,307,444,0.691441441441
1075,EFFINGHAM,648,5B,1457,2105,0.69216152019
2219,OGLETHORPE,538,Crawford,1214,1752,0.692922374429
108,BIBB,443,HAZZARD 4,1000,1443,0.693000693001
187,CALHOUN,130,Morgon,303,437,0.693363844394
974,DODGE,194,Eddin,439,633,0.693522906793
2481,THOMAS,140,Merrillville,317,457,0.693654266958
203,CAMDEN,425,Mush Bluff,963,1388,0.693804034582
2049,LOWNDES,1562,Rainwater,3542,5104,0.693965517241
1578,GLYNN,497,Ballard Complex,1128,1625,0.694153846154
1758,GWINNETT,713,SUWANEE H,1619,2332,0.694253859348
2066,MADISON,668,Hull,1518,2186,0.694419030192
1438,FULTON,77,ML05B,175,252,0.694444444444
542,COBB,789,Hayes 01,1796,2585,0.694777562863
1139,FAYETTE,408,DOGWOOD-03,929,1337,0.694839192221
1427,FULTON,97,ML012,221,318,0.694968553459
23,BAKER,32,Anna,73,105,0.695238095238
689,COLUMBIA,455,Belair Baptist Church,1039,1494,0.695448460509
694,COLUMBIA,423,Augusta Christian,967,1390,0.695683453237
1604,GRADY,159,Pine Park,364,523,0.695984703633
568,COBB,326,McClure 01,747,1073,0.696178937558
1124,FAYETTE,271,SHAKERAG WEST,622,893,0.696528555431
1419,FULTON,410,JC13A,942,1352,0.69674556213
1769,GWINNETT,464,HARBINS C,1074,1538,0.698309492848
1137,FAYETTE,359,HARPS CROSSING,836,1195,0.699581589958
700,COLUMBIA,348,Lakeside Middle,811,1159,0.699741156169
1191,FORSYTH,2416,21 South Forsyth,5636,8052,0.699950322901
684,COLUMBIA,267,Riverside Elementary,624,891,0.700336700337
297,CHATHAM,519,4-12 St Peters Episcopal,1213,1732,0.700346420323
664,COLUMBIA,861,Lewis Methodist Church,2013,2874,0.700417536534
191,CAMDEN,177,Tarboro,414,591,0.700507614213
2062,MADISON,240,Comer,562,802,0.700748129676
598,COBB,685,Pine Mountain 01,1605,2290,0.700873362445
262,CHATHAM,417,1-12 Isle of Hope Baptist,978,1395,0.701075268817
709,COLUMBIA,419,Blue Ridge Elementary,988,1407,0.702203269367
2411,SPALDING,422,FIRST PRESBYTERIA,996,1418,0.7023977433
2692,WORTH,127,Warwick,300,427,0.702576112412
558,COBB,324,Lewis 01,769,1093,0.703568161025
1712,GWINNETT,502,CATES N,1193,1695,0.70383480826
1435,FULTON,223,ML04B,530,753,0.70385126162
2621,WHEELER,248,Glenwood,590,838,0.704057279236
368,CHEROKEE,1003,CANTON,2390,3393,0.704391394047
266,CHATHAM,605,1-17 Islands Christian Church,1444,2049,0.704734016593
2366,ROCKDALE,278,Bethel,667,945,0.70582010582
2220,OGLETHORPE,808,Lexington,1940,2748,0.70596797671
1574,GLYNN,545,Sterling Church of God,1309,1854,0.706040992449
291,CHATHAM,437,4-05 St Francis Episcopal,1051,1488,0.706317204301
149,BULLOCH,118,Lockhart,285,403,0.707196029777
1443,FULTON,204,ML072,493,697,0.707317073171
2197,NEWTON,417,Oxford,1009,1426,0.707573632539
1433,FULTON,698,ML03,1690,2388,0.70770519263
1054,EARLY,102,Jakin,248,350,0.708571428571
1626,GWINNETT,876,PUCKETTS A,2132,3008,0.708776595745
681,COLUMBIA,399,Col Cty Bd Of Edu,972,1371,0.708971553611
740,COWETA,746,MADRAS,1822,2568,0.709501557632
1571,GLYNN,856,St Williams Church,2091,2947,0.709535120461
683,COLUMBIA,781,Redeemer Church,1910,2691,0.709773318469
192,CAMDEN,273,Waverly,668,941,0.709883103082
2388,SCREVEN,95,Rocky Ford,233,328,0.710365853659
387,CHEROKEE,362,R T JONES,888,1250,0.7104
2505,TOOMBS,975,513 V.P.D.,2394,3369,0.710596616207
992,DOOLY,101,PINEHURST,248,349,0.710601719198
2132,MONTGOMERY,89,Ailey,219,308,0.711038961039
1444,FULTON,128,ML07A,315,443,0.711060948081
74,BARTOW,1190,CARTERSVILLE WEST,2929,4119,0.711094925953
320,CHATHAM,208,7-03 P B Edwards Gym,514,722,0.711911357341
1976,JONES,253,BARRON,626,879,0.712172923777
2482,THOMAS,61,Metcalfe,151,212,0.712264150943
2533,TWIGGS,138,HIGGSVILLE,342,480,0.7125
298,CHATHAM,524,4-13 Skid Is Pres Church,1300,1824,0.712719298246
2570,WALTON,577,South Monroe,1435,2012,0.713220675944
1129,FAYETTE,265,OAK GROVE,660,925,0.713513513514
2047,LOWNDES,130,Naylor-001,324,454,0.713656387665
1146,FAYETTE,382,CAMP CREEK,953,1335,0.713857677903
736,COWETA,2041,ARTS CENTRE,5093,7134,0.713905242501
1081,ELBERT,221,Wyche,552,773,0.714100905563
41,BALDWIN,273,Coopers,682,955,0.714136125654
2232,PAULDING,1506,AUSTIN MIDDLE SCHOOL,3767,5273,0.714394083065
2396,SEMINOLE,229,Precinct 1,573,802,0.714463840399
1131,FAYETTE,337,ABERDEEN,844,1181,0.714648602879
2501,TIFT,534,Tifton Lodge,1344,1878,0.715654952077
2651,WHITFIELD,500,2A,1259,1759,0.715747583854
2206,OCONEE,332,Colham Ferry,836,1168,0.715753424658
1899,HOUSTON,824,ANNX,2076,2900,0.715862068966
1194,FORSYTH,2432,29 Polo,6129,8561,0.715921037262
152,BULLOCH,270,Portal,681,951,0.716088328076
2087,MCINTOSH,116,Townsend,293,409,0.716381418093
1120,FAYETTE,549,RAREOVER,1387,1936,0.716425619835
1853,HART,237,Bio,599,836,0.716507177033
1145,FAYETTE,370,WILLOWBEND,940,1310,0.717557251908
2224,PAULDING,1780,RUSSOM ELEM SCH,4526,6306,0.717729146844
290,CHATHAM,423,4-04 Lighthouse Baptist Ch,1076,1499,0.717811874583
1091,EMANUEL,90,Summertown,230,320,0.71875
753,CRAWFORD,25,3 - CITY,64,89,0.719101123596
693,COLUMBIA,343,Abilene Baptist,879,1222,0.719312602291
630,COBB,598,Vaughn 01,1538,2136,0.720037453184
698,COLUMBIA,523,Stevens Creek Church,1348,1871,0.720470336718
710,COLUMBIA,412,Christ The King Luth Ch,1063,1475,0.720677966102
1900,HOUSTON,1499,BMS,3873,5372,0.720960536113
1605,GRADY,93,Ragan,241,334,0.721556886228
1625,GWINNETT,812,DUNCANS A,2105,2917,0.721631813507
2160,MUSCOGEE,1129,ST. MARK/HEIFERHORN,2929,4058,0.721784130113
381,CHEROKEE,1235,LIBERTY,3204,4439,0.721784185627
2051,LOWNDES,632,Clyattville,1643,2275,0.722197802198
2130,MONROE,168,PROCTORS,438,606,0.722772277228
1657,GWINNETT,1024,DUNCANS D,2670,3694,0.722793719545
2638,WHITFIELD,315,FI,822,1137,0.722955145119
1967,JOHNSON,152,Bray,397,549,0.723132969035
359,CHEROKEE,491,AIR ACRES,1284,1775,0.72338028169
2208,OCONEE,125,Farmington,327,452,0.723451327434
2569,WALTON,714,Social Circle,1872,2586,0.723897911833
1069,EFFINGHAM,427,3D,1124,1551,0.72469374597
37,BALDWIN,614,North Baldwin,1623,2237,0.725525257041
2459,TELFAIR,116,Jacksonville,307,423,0.725768321513
2319,RICHMOND,273,303,725,998,0.726452905812
292,CHATHAM,383,4-06 First Baptist Church,1019,1402,0.726818830243
1147,FAYETTE,642,RISING STAR,1709,2351,0.726924712888
697,COLUMBIA,347,Genesis Church,926,1273,0.72741555381
150,BULLOCH,444,Emit,1190,1634,0.728274173807
2603,WASHINGTON,101,DEEPSTEP,271,372,0.728494623656
1915,HOUSTON,893,VHS,2398,3291,0.728653904588
94,BERRIEN,196,Alapaha,527,723,0.728907330567
89,BEN HILL,984,West,2646,3630,0.728925619835
1938,JACKSON,255,Attica,689,944,0.729872881356
221,CARROLL,702,V R COUNTY NORTH (641),1897,2599,0.72989611389
573,COBB,372,Marietta 4A,1008,1380,0.730434782609
380,CHEROKEE,758,KELLOGG,2058,2816,0.730823863636
1782,HALL,838,01-Wilson,2278,3116,0.731065468549
2213,OCONEE,412,Bogart,1120,1532,0.731070496084
1779,HABERSHAM,114,City of Baldwin,310,424,0.731132075472
86,BARTOW,734,CASSVILLE,1999,2733,0.731430662276
346,CHATTOOGA,58,CLOUDLAND,158,216,0.731481481481
2161,MUSCOGEE,514,WYNNBROOK,1402,1916,0.731732776618
675,COLUMBIA,256,G A Apostolic Church,699,955,0.731937172775
147,BRYAN,508,HWY 144 East,1389,1897,0.732208750659
647,COLQUITT,38,Crosland,104,142,0.732394366197
65,BARROW,466,11 Apalachee High School,1277,1743,0.732644865175
2235,PEACH,442,BYRON #1,1212,1654,0.73276904474
2100,MERIWETHER,66,GAY,181,247,0.732793522267
2636,WHITFIELD,500,DG,1372,1872,0.732905982906
217,CARROLL,632,FAIRFIELD (1540),1740,2372,0.733558178752
1747,GWINNETT,765,DUNCANS B,2114,2879,0.734282737061
1166,FLOYD,127,RIVERSIDE,351,478,0.734309623431
353,CHATTOOGA,758,SUMMERVILLE,2097,2855,0.734500875657
365,CHEROKEE,699,BOOTH,1943,2642,0.735427706283
1858,HEARD,305,FRANKLIN,848,1153,0.735472679965
2525,TROUP,302,GRAY HILL,843,1145,0.736244541485
1791,HALL,796,10-Candler,2225,3021,0.736511089043
1577,GLYNN,474,C B Greer School,1327,1801,0.736812881732
215,CARROLL,180,BOWDON JUNCTION (1496),504,684,0.736842105263
535,COBB,557,Ford 01,1562,2119,0.737140160453
686,COLUMBIA,395,Christ Sanctified,1108,1503,0.737192282102
294,CHATHAM,472,4-08 Wilmington Island Pr,1325,1797,0.73734001113
1566,GLYNN,466,Marshes of Glynn,1309,1775,0.737464788732
549,COBB,335,Kemp 01,943,1278,0.737871674491
2090,MCINTOSH,358,South Newport,1009,1367,0.73811265545
209,CARROLL,577,SANDHILL (1122),1631,2208,0.738677536232
1431,FULTON,244,ML023,692,936,0.739316239316
2015,LEE,492,Century Fire Station,1396,1888,0.739406779661
1859,HEARD,96,SOUTHWEST,273,369,0.739837398374
704,COLUMBIA,409,West Acres Baptist,1167,1576,0.740482233503
2354,RICHMOND,75,801B,214,289,0.740484429066
261,CHATHAM,199,1-10 Saint Thomas Episcopal Church,568,767,0.740547588005
363,CHEROKEE,664,BASCOMB,1898,2562,0.740827478532
1592,GORDON,1133,CALHOUN CITY,3244,4377,0.741146904272
520,COBB,718,Durham 01,2056,2774,0.741167988464
1569,GLYNN,612,Christian Renewal,1754,2366,0.741335587489
1977,JONES,30,SANDERS,86,116,0.741379310345
373,CHEROKEE,490,DEER RUN,1405,1895,0.741424802111
204,CAMDEN,527,West Saint Marys,1515,2042,0.741919686582
540,COBB,491,Harrison 01,1412,1903,0.741986337362
738,COWETA,305,EXPO CENTER,878,1183,0.742180896027
1836,HARRIS,701,ELLERSLIE,2021,2722,0.742468772961
2450,TATTNALL,43,Manassas,124,167,0.74251497006
739,COWETA,752,WHITE OAK,2170,2922,0.74264202601
2627,WHITE,257,Nacoochee,743,1000,0.743
1050,EARLY,107,Cuba,310,417,0.743405275779
1126,FAYETTE,615,WHITEWATER,1786,2401,0.743856726364
2209,OCONEE,319,Bishop,930,1249,0.744595676541
2548,UPSON,222,YATESVILLE,649,871,0.745120551091
136,BROOKS,85,Pavo,249,334,0.745508982036
2142,MORGAN,459,Central Morgan,1345,1804,0.7455654102
2060,MADISON,465,Colbert,1363,1828,0.745623632385
2121,MONROE,107,CABANISS,315,422,0.74644549763
2002,LAURENS,315,Rural Fire Sta #17,928,1243,0.746580852776
2643,WHITFIELD,691,PG,2036,2727,0.746607994133
146,BRYAN,595,Keller,1757,2352,0.747023809524
2473,THOMAS,136,Coolidge,403,539,0.747680890538
265,CHATHAM,447,1-16 Ferguson Ave Baptist,1326,1773,0.747884940778
1962,JENKINS,151,Perkins,448,599,0.747913188648
640,COFFEE,371,Broxton,1102,1473,0.748133061779
67,BARROW,329,13 Winder Community Center,978,1307,0.748278500383
1048,EARLY,40,Colomokee,119,159,0.748427672956
2502,TOOMBS,488,15361 Lyons,1453,1941,0.748583204534
2223,PAULDING,971,MOSES MIDDLE SCHOOL,2893,3864,0.748706004141
1575,GLYNN,259,SE Baptist Bldg,772,1031,0.748787584869
1846,HARRIS,228,WHITESVILLE,680,908,0.748898678414
2572,WALTON,551,Loganville South,1646,2197,0.749203459263
2664,WILKES,95,Metasville Fire Station,284,379,0.749340369393
1787,HALL,476,06-Flowery Branch II,1426,1902,0.749737118822
1096,EMANUEL,54,Nunez,162,216,0.75
196,CAMDEN,361,West Kingsland,1088,1449,0.750862663906
2210,OCONEE,320,High Shoals,965,1285,0.750972762646
1608,GRADY,180,Whigham,543,723,0.751037344398
639,COFFEE,50,Bridgetown,151,201,0.751243781095
2187,NEWTON,500,Brewers,1511,2011,0.751367478866
2012,LEE,629,First Baptist,1901,2530,0.751383399209
1988,LANIER,84,Westside,254,338,0.751479289941
2106,MILLER,622,Colquitt-Miller,1888,2510,0.75219123506
1630,GWINNETT,496,DUNCANS C,1506,2002,0.752247752248
2218,OGLETHORPE,483,Beaverdam,1468,1951,0.752434648898
1570,GLYNN,449,Oglethorpe Point,1366,1815,0.75261707989
1184,FORSYTH,2803,10 Midway-7,8548,11351,0.753061404282
2026,LIBERTY,400,Fleming East,1220,1620,0.753086419753
706,COLUMBIA,451,Wesley Methodist,1376,1827,0.753147235906
1436,FULTON,17,ML04C,52,69,0.753623188406
1430,FULTON,33,ML022,101,134,0.753731343284
2351,RICHMOND,49,708,150,199,0.753768844221
2498,TIFT,474,Tifton Northwest,1453,1927,0.754021795537
2138,MONTGOMERY,148,Uvalda,454,602,0.75415282392
695,COLUMBIA,289,Stevens Creek Elem,887,1176,0.75425170068
2430,SUMTER,71,AndersonV,218,289,0.754325259516
2414,SPALDING,235,SUNNYSIDE METHODI,722,957,0.754440961338
1925,JACKSON,345,North Minish,1061,1406,0.754623044097
2419,SPALDING,405,FIRST ASSEMBLY,1247,1652,0.754842615012
2042,LONG,93,Faith Baptist Annex,288,381,0.755905511811
1978,JONES,392,FINNEY,1214,1606,0.755915317559
1182,FORSYTH,438,07 Cumming,1358,1796,0.756124721604
555,COBB,680,Lost Mountain 02,2112,2792,0.756446991404
984,DODGE,116,Pondtown,361,477,0.756813417191
59,BARROW,645,05 Fire Station 1 (Statham),2008,2653,0.7568790049
157,BULLOCH,290,Blitch,903,1193,0.75691533948
708,COLUMBIA,441,Christ Church,1380,1821,0.757825370675
2476,THOMAS,237,Fire Station 2,742,979,0.757916241062
1567,GLYNN,380,Satilla Marsh School,1190,1570,0.757961783439
2225,PAULDING,1350,MT TABOR PARK,4229,5579,0.758021150744
2513,TROUP,572,HOLLIS HAND,1792,2364,0.758037225042
691,COLUMBIA,274,Westside Bapt Church,859,1133,0.758164165931
1898,HENRY,311,TIMBERRIDGE,980,1291,0.759101471727
2616,WAYNE,275,Unity,869,1144,0.759615384615
1790,HALL,652,09-Morgan II,2062,2714,0.759764185704
1812,HALL,364,31-Friendship IV,1153,1517,0.760052735662
2394,SCREVEN,53,Jackson Fire Station,168,221,0.760180995475
2192,NEWTON,653,Gum Creek,2071,2724,0.760279001468
206,CANDLER,403,Candler-1736,1280,1683,0.7605466429
1153,FLOYD,223,CAVE SPRING,709,932,0.760729613734
1928,JACKSON,273,Redstone,868,1141,0.760736196319
1576,GLYNN,395,Career Academy,1256,1651,0.760751059964
376,CHEROKEE,816,HICKORY FLAT,2599,3415,0.761054172767
1429,FULTON,290,ML021,924,1214,0.761120263591
599,COBB,501,Pine Mountain 02,1597,2098,0.761201143947
2523,TROUP,499,LONG CANE,1591,2090,0.761244019139
393,CHEROKEE,911,TOONIGH,2911,3822,0.761643118786
1946,JEFF DAVIS,91,Blackburn 1,291,382,0.761780104712
775,DECATUR,132,Brinson,423,555,0.762162162162
687,COLUMBIA,256,Blanchard Park,821,1077,0.762302692665
551,COBB,633,Kemp 03,2032,2665,0.762476547842
1969,JONES,405,GRAY,1302,1707,0.762741652021
1171,FLOYD,96,VANNS VALLEY,309,405,0.762962962963
1904,HOUSTON,251,HAFS,810,1061,0.76343072573
774,DECATUR,154,Climax,497,651,0.763440860215
981,DODGE,56,Mitchell,181,237,0.763713080169
678,COLUMBIA,208,Eubank/Blanchard Center,673,881,0.763904653802
668,COLUMBIA,185,Harlem Middle School-12,600,785,0.764331210191
2276,POLK,772,ROCKMART,2506,3278,0.764490543014
1086,ELBERT,65,Webbsboro,211,276,0.764492753623
665,COLUMBIA,207,Woodlawn Baptist Church,672,879,0.764505119454
2408,SPALDING,267,BOY SCOUTS HDQTRS,867,1134,0.76455026455
1432,FULTON,16,ML024,52,68,0.764705882353
2188,NEWTON,394,Brick Store,1282,1676,0.76491646778
2010,LEE,458,Leesburg,1491,1949,0.765007696254
60,BARROW,278,06 Winder Barrow High School,908,1186,0.765598650927
1053,EARLY,45,Hilton,147,192,0.765625
145,BRYAN,439,J.F. Gregory Park,1435,1874,0.765741728922
1198,FRANKLIN,294,Lavonia,963,1257,0.766109785203
2270,PIKE,310,Zebulon,1016,1326,0.766214177979
1923,IRWIN,36,Holt,118,154,0.766233766234
1991,LAURENS,551,Fire Dept Sta #5,1809,2360,0.766525423729
1894,HENRY,483,MT. BETHEL,1592,2075,0.767228915663
388,CHEROKEE,583,ROSECREEK,1922,2505,0.767265469062
2531,TWIGGS,200,DRY BRANCH,660,860,0.767441860465
1109,FANNIN,50,SKENIAH,165,215,0.767441860465
982,DODGE,70,Mullis,231,301,0.767441860465
1162,FLOYD,483,EAST LINDALE,1594,2077,0.767453057294
18,BACON,476,Douglas,1571,2047,0.767464582316
725,COWETA,586,FISCHER ROAD,1940,2526,0.76801266825
2483,THOMAS,294,New Covenant,979,1273,0.769049489395
1983,LAMAR,403,L C S C,1342,1745,0.769054441261
140,BRYAN,299,Danielsiding,1000,1299,0.769822940724
1150,FLOYD,441,ALTO PARK,1477,1918,0.770072992701
2207,OCONEE,204,Antioch,685,889,0.770528683915
1871,HENRY,493,MCMULLEN,1657,2150,0.770697674419
1926,JACKSON,576,South Jefferson,1939,2515,0.77097415507
111,BIBB,101,HOWARD 2 - 02,340,441,0.770975056689
133,BROOKS,51,Barwick,172,223,0.77130044843
2617,WAYNE,206,Rec Center,696,902,0.771618625277
1076,EFFINGHAM,219,5C,740,959,0.771637122002
2624,WHITE,78,Helen,264,342,0.771929824561
2031,LINCOLN,223,Lincoln Center,756,979,0.772216547497
768,DAWSON,363,West,1232,1595,0.772413793103
1920,IRWIN,38,Osierfield,129,167,0.77245508982
128,BLECKLEY,1094,FAIRGROUND,3717,4811,0.77260444814
2470,THOMAS,97,Barwick,330,427,0.772833723653
773,DECATUR,77,Kendrick,262,339,0.772861356932
2145,MORGAN,375,North Morgan,1276,1651,0.772864930345
208,CARROLL,365,BOWDON (1111),1243,1608,0.773009950249
702,COLUMBIA,282,Gold Cross EMS,962,1244,0.773311897106
2233,PAULDING,1054,NEBO ELEMENTARY SCH,3603,4657,0.773674039081
1951,JEFF DAVIS,64,Ocmulgee 2,219,283,0.773851590106
2122,MONROE,104,COX,356,460,0.773913043478
2449,TATTNALL,191,Collins,655,846,0.774231678487
2140,MORGAN,298,East Morgan,1022,1320,0.774242424242
2497,TIFT,161,Ty Ty,554,715,0.774825174825
234,CARROLL,310,OLD CAMP CHURCH (714BW),1067,1377,0.774872912128
714,COOK,165,Lenox,568,733,0.774897680764
159,BULLOCH,371,Brooklet,1278,1649,0.775015160703
378,CHEROKEE,498,HILLSIDE,1722,2220,0.775675675676
2241,PEACH,192,POWERSVILLE,665,857,0.775962660443
2558,WALKER,669,ROSSVILLE,2318,2987,0.776029460998
581,COBB,472,Mars Hill 01,1638,2110,0.776303317536
1972,JONES,331,CLINTON,1155,1486,0.777254374159
1066,EFFINGHAM,162,3A,566,728,0.777472527473
2211,OCONEE,170,North Oconee,594,764,0.777486910995
2392,SCREVEN,121,Greenhill Church,423,544,0.777573529412
985,DODGE,125,Rawlins,438,563,0.777975133215
972,DODGE,57,Chauncey,200,257,0.778210116732
2463,TELFAIR,45,Scotland,158,203,0.778325123153
730,COWETA,387,PANTHER CREEK,1360,1747,0.778477389811
1188,FORSYTH,1275,16 Otwell-7,4481,5756,0.778492008339
2404,SPALDING,180,THIRD WARD,634,814,0.77886977887
641,COFFEE,225,Nicholls,795,1020,0.779411764706
360,CHEROKEE,617,ARNOLD MILL,2183,2800,0.779642857143
1940,JASPER,229,WYATT,811,1040,0.779807692308
1872,HENRY,465,EAST LAKE,1647,2112,0.779829545455
1078,ELBERT,94,Longstreet,333,427,0.779859484778
385,CHEROKEE,458,OAK GROVE,1624,2082,0.780019212296
1553,GILMER,129,CHERRY LOG,458,587,0.780238500852
246,CATOOSA,657,WESTSIDE,2334,2991,0.780341023069
1065,EFFINGHAM,462,2C,1642,2104,0.780418250951
397,CHEROKEE,352,WALESKA,1259,1611,0.781502172564
2080,MCDUFFIE,253,Dearing UMC,905,1158,0.781519861831
682,COLUMBIA,387,Greenbrier High,1392,1779,0.782462057336
1183,FORSYTH,1173,08 Mashburn,4224,5397,0.782657031684
2628,WHITE,48,Robertstown,173,221,0.782805429864
767,DADE,226,NORTH DADE,815,1041,0.782901056676
657,COLQUITT,278,Norman Park,1006,1284,0.783489096573
390,CHEROKEE,428,SIXES,1550,1978,0.783619817998
384,CHEROKEE,432,MOUNTAIN ROAD,1565,1997,0.78367551327
719,COWETA,716,SENOIA,2596,3312,0.783816425121
241,CATOOSA,486,FORT OGLETHORPE,1764,2250,0.784
1125,FAYETTE,524,STARRSMILL,1902,2426,0.784006595218
2076,MARION,100,Ft. Perry,363,463,0.784017278618
2112,MITCHELL,49,Hopeful,178,227,0.784140969163
162,BULLOCH,140,Nevils,509,649,0.784283513097
1785,HALL,534,04-Oakwood II,1945,2479,0.78459056071
1068,EFFINGHAM,226,3C,824,1050,0.784761904762
2125,MONROE,240,EVERS,876,1116,0.784946236559
184,BUTTS,497,TOWALIGA,1816,2313,0.785127539991
1927,JACKSON,456,South Minish,1671,2127,0.785613540197
55,BARROW,365,01 Bethlehem Community Center,1339,1704,0.785798122066
1200,FRANKLIN,251,Royston,921,1172,0.785836177474
2383,SCHLEY,401,Precinct One,1472,1873,0.785904965296
367,CHEROKEE,707,BRIDGEMILL,2596,3303,0.785952164699
1809,HALL,1107,28-Friendship I,4065,5172,0.78596287703
2542,UNION,86,Suches,316,402,0.786069651741
1085,ELBERT,208,Goshen,766,974,0.786447638604
2496,TIFT,89,Omega,328,417,0.786570743405
235,CARROLL,191,OAK GROVE (715),704,895,0.786592178771
2507,TOWNS,462,Young Harris,1703,2165,0.786605080831
392,CHEROKEE,939,TEASLEY,3463,4402,0.78668786915
1064,EFFINGHAM,356,2B,1334,1690,0.789349112426
1937,JACKSON,124,Center,465,589,0.789473684211
1603,GRADY,177,Midway,664,841,0.78953626635
72,BARTOW,432,ALLATOONA,1623,2055,0.789781021898
2263,PIKE,183,Concord,689,872,0.790137614679
2014,LEE,321,Sovereign Grace,1212,1533,0.79060665362
1160,FLOYD,381,GLENWOOD,1442,1823,0.791003839824
2561,WALKER,307,FAIRVIEW,1162,1469,0.791014295439
1023,DOUGLAS,636,DAY STAR,2410,3046,0.791201575837
2117,MITCHELL,52,Sale City,198,250,0.792
1611,GREENE,110,Greshamville,420,530,0.792452830189
243,CATOOSA,372,LAKEVIEW,1421,1793,0.792526491913
692,COLUMBIA,156,Trinity Bapt Church,596,752,0.792553191489
2547,UPSON,1034,REDBONE,3956,4990,0.792785571142
2522,TROUP,468,MCLENDON,1791,2259,0.792828685259
1839,HARRIS,346,LOWER 19TH,1326,1672,0.793062200957
2141,MORGAN,112,Beth/Springfield,430,542,0.793357933579
1811,HALL,542,30-Friendship III,2081,2623,0.79336637438
1835,HARRIS,378,CATAULA,1454,1832,0.793668122271
2403,SPALDING,192,SENIOR CENTER,740,932,0.793991416309
1997,LAURENS,203,Brewton,783,986,0.794117647059
2074,MARION,49,Tazewell,189,238,0.794117647059
245,CATOOSA,883,RINGGOLD,3412,4295,0.794412107101
1177,FORSYTH,544,03 Browns Bridge-7,2107,2651,0.794794417201
1420,FULTON,35,JC13B,136,171,0.795321637427
81,BARTOW,648,MISSION ROAD,2519,3167,0.795389958952
2407,SPALDING,227,FIRST METHODIST,883,1110,0.795495495495
1072,EFFINGHAM,110,4B-12,429,539,0.795918367347
2689,WORTH,134,Red Rock,523,657,0.79604261796
57,BARROW,337,03 Bramlett Elementary School,1317,1654,0.796251511487
712,COOK,279,Delle Beamguard,1092,1371,0.796498905908
2556,WALKER,721,CHATTANOOGA VALLEY,2825,3546,0.796672306825
63,BARROW,417,09 Lions Club,1634,2051,0.796684544125
2118,MONROE,322,BENTONS,1262,1584,0.796717171717
1589,GORDON,80,OOSTANAULA,314,394,0.796954314721
396,CHEROKEE,366,VICTORIA,1438,1804,0.79711751663
214,CARROLL,419,CLEM (1483),1647,2066,0.797192642788
58,BARROW,284,04 Westside Middle School,1117,1401,0.797287651677
142,BRYAN,282,Black Creek,1111,1393,0.797559224695
1994,LAURENS,54,Burch,213,267,0.797752808989
2661,WILCOX,145,Abbeville South 5,572,717,0.797768479777
1134,FAYETTE,278,BRAELINN,1097,1375,0.797818181818
78,BARTOW,420,EUHARLEE,1659,2079,0.79797979798
2399,SEMINOLE,143,Precinct 4,565,708,0.79802259887
398,CHEROKEE,387,WILDCAT,1530,1917,0.798122065728
1986,LANIER,55,Sirmans,218,273,0.798534798535
2255,PIERCE,375,Hacklebarney/Cason,1491,1866,0.799035369775
220,CARROLL,297,V R COUNTY SOUTH (640),1182,1479,0.799188640974
1801,HALL,539,20-West Whelchel,2147,2686,0.799329858526
1155,FLOYD,613,ETOWAH,2442,3055,0.799345335516
2053,LOWNDES,419,S Lowndes,1670,2089,0.79942556247
75,BARTOW,613,BEAVERS DRIVE,2446,3059,0.79960771494
195,CAMDEN,228,Harrietts Bluff,910,1138,0.799648506151
2194,NEWTON,266,Leguinn,1064,1330,0.8
1080,ELBERT,51,Petersburg,204,255,0.8
1793,HALL,374,12-Glade,1499,1873,0.800320341698
2611,WAYNE,275,Altamaha,1106,1381,0.800868935554
2544,UNION,187,Dooley,753,940,0.801063829787
2104,MERIWETHER,66,RALEIGH,266,332,0.801204819277
980,DODGE,42,Milan,170,212,0.801886792453
2196,NEWTON,105,Newborn,425,530,0.801886792453
732,COWETA,498,TURIN,2016,2514,0.801909307876
1094,EMANUEL,83,Canoochee,336,419,0.801909307876
744,COWETA,661,THOMAS CROSSROADS,2677,3338,0.801977231875
1049,EARLY,37,Cedar Springs,150,187,0.802139037433
1070,EFFINGHAM,353,4A,1432,1785,0.802240896359
2477,THOMAS,259,Gatlin Creek,1051,1310,0.802290076336
1087,ELBERT,123,Centerville,501,624,0.802884615385
2144,MORGAN,326,West Morgan,1330,1656,0.803140096618
2212,OCONEE,369,Dark Corner,1510,1879,0.803618946248
1079,ELBERT,102,Eliam,418,520,0.803846153846
2685,WORTH,162,Sylver East,664,826,0.80387409201
765,DADE,131,WEST BROW,537,668,0.803892215569
1788,HALL,644,07-Roberts,2643,3287,0.804076665653
729,COWETA,379,WELCOME,1557,1936,0.80423553719
2649,WHITFIELD,312,WS,1282,1594,0.804265997491
1848,HART,205,Goldmine,843,1048,0.804389312977
1025,DOUGLAS,514,EPHESUS BAPTIST CHUR,2119,2633,0.804785415875
1173,FLOYD,300,WEST LINDALE,1237,1537,0.804814573845
1565,GLYNN,463,Sterling Elem School,1910,2373,0.804888327012
366,CHEROKEE,557,BRADSHAW,2306,2863,0.805448829899
2519,TROUP,398,EAST VERNON,1648,2046,0.805474095797
726,COWETA,654,CEDAR CREEK,2711,3365,0.805646359584
1998,LAURENS,151,Dudley,626,777,0.805662805663
2551,WALKER,630,LAFAYETTE,2612,3242,0.805675508945
772,DECATUR,87,Recovery,361,448,0.805803571429
489,CLINCH,39,Argyle,162,201,0.805970149254
1180,FORSYTH,666,05 Coal Mountain,2770,3436,0.806169965076
2252,PICKENS,246,JASPER,1024,1270,0.806299212598
2321,RICHMOND,64,305,267,331,0.80664652568
2221,PAULDING,1300,SAMMY MCCLURE MID SC,5441,6741,0.80715027444
2422,STEPHENS,1835,Senior Center,7682,9517,0.807187138804
379,CHEROKEE,292,HOLLY SPRINGS,1224,1516,0.807387862797
2486,THOMAS,83,Pavo,348,431,0.807424593968
2228,PAULDING,724,SARA RAGSDALE ELM SC,3036,3760,0.807446808511
56,BARROW,423,02 Bethabra Baptist Church,1775,2198,0.807552320291
1384,FULTON,49,CH05,206,255,0.807843137255
1786,HALL,444,05-Flowery Branch I,1868,2312,0.807958477509
762,DADE,140,NEW SALEM,590,730,0.808219178082
2243,PICKENS,340,SHARPTOP,1434,1774,0.808342728298
745,COWETA,206,COWETA CENTRAL LIBRARY,869,1075,0.808372093023
2557,WALKER,161,KENSINGTON,683,844,0.809241706161
12,APPLING,79,5B,336,415,0.809638554217
2663,WILKES,161,Young Farmer's Bldg,685,846,0.809692671395
2041,LONG,31,Alma Flournoy,132,163,0.80981595092
141,BRYAN,199,Ellabell,848,1047,0.809933142311
645,COLQUITT,147,Autreyville,627,774,0.81007751938
2124,MONROE,113,DILLARDS,482,595,0.810084033613
135,BROOKS,234,Briggs,1001,1235,0.810526315789
2114,MITCHELL,140,Lester,599,739,0.810554803789
705,COLUMBIA,107,Journey Comm. Church,458,565,0.810619469027
1948,JEFF DAVIS,106,Whitehead 1,454,560,0.810714285714
2555,WALKER,132,MOUNTAIN,566,698,0.810888252149
2131,MONROE,52,RUSSELLVILLE,223,275,0.810909090909
2070,MADISON,231,Pittman,992,1223,0.811120196239
160,BULLOCH,192,Stilson,827,1019,0.811579980373
1776,HABERSHAM,610,Habersham South,2630,3240,0.811728395062
2412,SPALDING,177,LIBERTY,766,943,0.81230116649
2648,WHITFIELD,581,VA,2520,3101,0.812641083521
2054,LUMPKIN,2216,Dahlonega,9613,11829,0.812663792375
2043,LOWNDES,553,Hahira,2400,2953,0.812732814087
1616,GREENE,232,Walker,1007,1239,0.812752219532
2540,UNION,190,Owltown,825,1015,0.812807881773
6,APPLING,154,3C,670,824,0.813106796117
2286,RABUN,1443,Rabun,6287,7730,0.813324708926
1982,LAMAR,75,REDBONE,327,402,0.813432835821
238,CATOOSA,660,BOYNTON,2880,3540,0.813559322034
1617,GREENE,546,Old Salem,2385,2931,0.813715455476
2266,PIKE,176,Molena,769,945,0.813756613757
213,CARROLL,149,BURWELL (1371),652,801,0.813982521848
2447,TATTNALL,78,Cobbtown,342,420,0.814285714286
1591,GORDON,589,GORDON COUNTY,2585,3174,0.814429741651
2007,LEE,554,Redbone,2432,2986,0.81446751507
2568,WALTON,535,Loganville North,2350,2885,0.814558058925
638,COFFEE,229,Ambrose,1006,1235,0.814574898785
2134,MONTGOMERY,157,Higgston,690,847,0.814639905549
1107,FANNIN,223,MORGANTON,981,1204,0.814784053156
62,BARROW,328,08 First Baptist Church Winder,1444,1772,0.814898419865
242,CATOOSA,442,GRAYSVILLE,1949,2391,0.815140108741
1851,HART,144,Bowersville,637,781,0.81562099872
66,BARROW,287,12 Midway United Methodist Church,1272,1559,0.815907633098
2237,PEACH,99,CLAUDE,442,541,0.817005545287
1111,FANNIN,349,TOCCOA,1564,1913,0.817564035546
741,COWETA,441,CANNONGATE,1981,2422,0.817919075145
223,CARROLL,372,TEMPLE COUNTY (649),1672,2044,0.818003913894
1186,FORSYTH,4,15 Heardsville-7,18,22,0.818181818182
2510,TOWNS,394,Hiawassee,1773,2167,0.818181818182
2670,WILKINSON,22,Griffin,99,121,0.818181818182
87,BARTOW,146,WOODLAND HIGH,658,804,0.818407960199
1850,HART,324,Reed Creek,1461,1785,0.818487394958
1127,FAYETTE,312,WOOLSEY,1410,1722,0.81881533101
724,COWETA,520,SHARPSBURG,2350,2870,0.81881533101
2671,WILKINSON,21,High Hill,95,116,0.818965517241
1548,GILMER,302,ELLIJAY SOUTH,1371,1673,0.819485953377
2120,MONROE,292,BURGAYS,1328,1620,0.81975308642
2546,UNION,224,Pat Colwell,1020,1244,0.819935691318
2644,WHITFIELD,383,TH,1747,2130,0.820187793427
2108,MITCHELL,71,Branchville,324,395,0.820253164557
2185,NEWTON,46,Alcovy-10,210,256,0.8203125
1862,HENRY,491,SANDY RIDGE,2246,2737,0.820606503471
1074,EFFINGHAM,283,5A,1296,1579,0.820772640912
1061,EFFINGHAM,139,1C,637,776,0.82087628866
667,COLUMBIA,63,Harlem Middle School-10,289,352,0.821022727273
2687,WORTH,91,Sumner,418,509,0.821218074656
2607,WAYNE,155,Screven,712,867,0.82122260669
2566,WALTON,527,Between,2427,2954,0.821597833446
2586,WARE,408,300,1879,2287,0.821600349803
1100,FANNIN,122,COLWELL,562,684,0.821637426901
1560,GILMER,205,ELLIJAY NORTHEAST,949,1154,0.822357019064
1984,LAMAR,404,MILNER,1878,2282,0.82296231376
2222,PAULDING,267,NORTHSIDE ELEM SCH,1242,1509,0.823061630219
68,BARROW,124,14 Cedar Creek Baptist Church,577,701,0.823109843081
2686,WORTH,93,Poulan,434,527,0.823529411765
1799,HALL,371,18-Fork,1732,2103,0.823585354256
1056,EARLY,28,Urquhart,131,159,0.823899371069
1781,HABERSHAM,174,Amys Creek,815,989,0.82406471183
383,CHEROKEE,520,MACEDONIA,2437,2957,0.824146094014
1810,HALL,330,29-Friendship II,1547,1877,0.824187533298
2543,UNION,132,Trackrock,619,751,0.824234354194
1165,FLOYD,168,NORTH CAROLINA,789,957,0.824451410658
2635,WHITFIELD,137,CO,644,781,0.824583866837
1108,FANNIN,94,NOONTOOTLA,442,536,0.824626865672
355,CHATTOOGA,96,DIRTTOWN,453,549,0.825136612022
2242,PICKENS,365,YELLOW CREEK,1725,2090,0.825358851675
394,CHEROKEE,436,UNION HILL,2062,2498,0.825460368295
1800,HALL,468,19-Whelchel,2214,2682,0.825503355705
351,CHATTOOGA,94,LYERLY,445,539,0.82560296846
761,DADE,94,SOUTH DADE,445,539,0.82560296846
1992,LAURENS,143,Bailey,679,822,0.82603406326
77,BARTOW,289,EMERSON,1379,1668,0.826738609113
2011,LEE,130,Friendship Bapt,622,752,0.827127659574
715,COOK,93,Massee,445,538,0.827137546468
1559,GILMER,152,BIG CREEK,728,880,0.827272727273
2035,LINCOLN,142,Martins Crossroad,682,824,0.827669902913
722,COWETA,94,DRESDEN,453,547,0.828153564899
756,CRISP,81,Arabi,391,472,0.828389830508
2283,PUTNAM,408,107,1973,2381,0.828643427131
1778,HABERSHAM,69,Town of Mount Airy,334,403,0.828784119107
194,CAMDEN,69,Browntown,334,403,0.828784119107
358,CHATTOOGA,93,ALPINE,451,544,0.829044117647
2272,POLK,162,BLOOMING GROVE,790,952,0.829831932773
1980,LAMAR,146,CHAPPELL MILL V. FD,713,859,0.830034924331
2577,WALTON,221,W Monroe,1081,1302,0.830261136713
1095,EMANUEL,53,Garfield,260,313,0.830670926518
76,BARTOW,372,CENTER,1825,2197,0.830678197542
1154,FLOYD,120,CHULIO,591,711,0.831223628692
2484,THOMAS,120,Ochlocknee,591,711,0.831223628692
1564,GLASCOCK,53,Mitchell,262,315,0.831746031746
1939,JACKSON,459,Porter,2271,2730,0.831868131868
2420,SPALDING,219,ROBERTS,1084,1303,0.831926323868
1557,GILMER,154,ELLIJAY NORTH,763,917,0.832061068702
1101,FANNIN,107,FAIRPLAY,532,639,0.83255086072
2204,NEWTON,267,Hub,1331,1598,0.832916145181
2084,MCDUFFIE,141,Marshall Church,703,844,0.832938388626
2475,THOMAS,126,Ellabelle,629,755,0.833112582781
1595,GORDON,256,RED BUD,1278,1534,0.833116036506
325,CHATHAM,220,7-08 Bloomingdale Com Ctr,1102,1322,0.833585476551
2536,UNION,252,Blairsville,1263,1515,0.833663366337
71,BARTOW,565,ADAIRSVILLE,2834,3399,0.8337746396
1841,HARRIS,119,PINE MOUNTAIN VALLEY,599,718,0.83426183844
720,COWETA,253,MORELAND,1274,1527,0.834315651604
2129,MONROE,139,MIDDLEBROOKS,706,845,0.83550295858
2150,MURRAY,542,TOWN,2753,3295,0.835508345979
1840,HARRIS,317,MULBERRY GROVE,1615,1932,0.835921325052
2622,WHITE,231,Blue Creek,1177,1408,0.8359375
1798,HALL,361,17-Chestatee,1846,2207,0.836429542365
2281,PUTNAM,373,105,1912,2285,0.836761487965
2485,THOMAS,44,Patten,226,270,0.837037037037
1103,FANNIN,122,HEMPTOWN,628,750,0.837333333333
226,CARROLL,146,ROOPVILLE (713),752,898,0.837416481069
2452,TATTNALL,233,East Glennville,1201,1434,0.837517433752
2127,MONROE,153,HIGH FALLS,790,943,0.837751855779
1102,FANNIN,287,FLINTHILL,1482,1769,0.837761447145
1063,EFFINGHAM,249,2A,1288,1537,0.837996096291
92,BERRIEN,561,Nashville,2904,3465,0.838095238095
2147,MURRAY,257,SHUCK PEN,1333,1590,0.838364779874
352,CHATTOOGA,306,TRION,1588,1894,0.838437170011
731,COWETA,234,RAYMOND,1218,1452,0.838842975207
2149,MURRAY,326,SPRING PLACE,1700,2026,0.839091806515
1110,FANNIN,222,SUGAR CREEK,1161,1383,0.839479392625
1974,JONES,147,DAVIDSON,770,917,0.839694656489
2642,WHITFIELD,222,NI,1163,1385,0.839711191336
1052,EARLY,28,Freeman,147,175,0.84
2508,TOWNS,4,Tate City,21,25,0.84
658,COLQUITT,82,Robinson,431,513,0.840155945419
91,BERRIEN,159,Ray City,837,996,0.840361445783
1187,FORSYTH,774,15 Heardsville-9,4075,4849,0.840379459682
2541,UNION,189,Ivy Log,997,1186,0.840640809444
240,CATOOSA,258,CHAMBERS,1362,1620,0.840740740741
395,CHEROKEE,502,UNIVETER,2654,3156,0.840937896071
1931,JACKSON,190,Harrisburg,1006,1196,0.841137123746
1797,HALL,514,16-Bark Camp,2724,3238,0.84126003706
1556,GILMER,151,EAST ELLIJAY,802,953,0.841552990556
1823,HARALSON,558,BREMEN,2968,3526,0.841747022121
2539,UNION,191,Jones Creek,1020,1211,0.842279108175
1151,FLOYD,122,ARMUCHEE,654,776,0.842783505155
1181,FORSYTH,588,06 Crossroads,3157,3745,0.842990654206
216,CARROLL,164,TYUS (1533),881,1045,0.843062200957
728,COWETA,217,HARALSON,1166,1383,0.84309472162
2579,WALTON,115,Mountain,618,733,0.843110504775
2554,WALKER,124,ARMUCHEE VALLEY,667,791,0.843236409608
1597,GRADY,77,Blowing Cave,415,492,0.843495934959
1833,HARALSON,258,TALLAPOOSA,1394,1652,0.84382566586
2259,PIERCE,115,Patterson,622,737,0.843962008141
1554,GILMER,136,BOARDTOWN,737,873,0.84421534937
2626,WHITE,384,Mt. Yonah,2082,2466,0.844282238443
1555,GILMER,106,MOUNTAINTOWN,575,681,0.844346549192
375,CHEROKEE,525,FREEHOME,2850,3375,0.844444444444
2509,TOWNS,346,Macedonia,1880,2226,0.844564240791
69,BARROW,295,15 County Line Elementary School,1604,1899,0.844655081622
1058,EFFINGHAM,149,1A,811,960,0.844791666667
2003,LAURENS,87,Reedy Springs,475,562,0.845195729537
1843,HARRIS,150,UPPER 19TH,823,973,0.845837615622
1193,FORSYTH,859,27 Concord,4726,5585,0.846195165622
244,CATOOSA,384,POPLAR SPRINGS,2120,2504,0.846645367412
2645,WHITFIELD,64,TI,354,418,0.846889952153
1552,GILMER,223,LEACHES,1235,1458,0.847050754458
1831,HARALSON,151,SEVENTH,837,988,0.847165991903
2634,WHITFIELD,142,CA,788,930,0.847311827957
2274,POLK,240,FISH CREEK,1334,1574,0.847522236341
212,CARROLL,161,MT ZION (1240),897,1058,0.847826086957
2682,WORTH,64,County Line,358,422,0.848341232227
1856,HEARD,84,ENON GROVE,471,555,0.848648648649
247,CATOOSA,270,WOODSTATION,1519,1789,0.849077697037
80,BARTOW,222,KINGSTON,1251,1473,0.849287169043
2520,TROUP,346,ROSEMONT,1951,2297,0.849368741837
1104,FANNIN,108,HOTHOUSE,611,719,0.849791376912
2630,WHITE,97,Tesnatee,549,646,0.849845201238
1775,HABERSHAM,819,Habersham North,4639,5458,0.849945034811
1059,EFFINGHAM,144,1B-1,816,960,0.85
347,CHATTOOGA,48,PENNVILLE,272,320,0.85
979,DODGE,31,McCranie,176,207,0.850241545894
655,COLQUITT,131,Monk,745,876,0.850456621005
2271,POLK,262,ARAGON,1493,1755,0.850712250712
2610,WAYNE,84,Red Hill,480,564,0.851063829787
1924,JACKSON,636,North Jefferson,3638,4274,0.851193261582
1609,GRADY,215,Woodland,1242,1457,0.852436513384
2246,PICKENS,158,HILL,913,1071,0.852474323063
1852,HART,132,Shoal Creek,764,896,0.852678571429
652,COLQUITT,139,Hopewell,805,944,0.852754237288
2559,WALKER,577,CHICKAMAUGA,3345,3922,0.85288118307
371,CHEROKEE,317,CLAYTON,1841,2158,0.853104726599
2244,PICKENS,167,APPALACHIAN,970,1137,0.853122251539
2681,WORTH,110,Bridgeboro,639,749,0.853137516689
1590,GORDON,95,OAKMAN,552,647,0.853168469861
2052,LOWNDES,344,Dasher,2000,2344,0.853242320819
239,CATOOSA,214,CATOOSA KEITH,1245,1459,0.853324194654
2293,RANDOLPH,12,Fountain Bridge-4th,70,82,0.853658536585
2456,TAYLOR,203,#5 COURTHOUSE,1186,1389,0.853851691865
2538,UNION,122,Choestoe,713,835,0.853892215569
2587,WARE,89,304,522,611,0.854337152209
2034,LINCOLN,56,Bethany Church,329,385,0.854545454545
1098,EMANUEL,68,Adrian,401,469,0.855010660981
2063,MADISON,257,Danielsville,1516,1773,0.855047941342
2537,UNION,210,Coosa,1239,1449,0.855072463768
1963,JENKINS,91,Senior Citizens Bld,537,628,0.855095541401
1197,FRANKLIN,216,NorthEast Franklin,1276,1492,0.855227882038
1156,FLOYD,40,EVERETT SPRINGS,237,277,0.85559566787
1178,FORSYTH,464,03 Browns Bridge-9,2750,3214,0.855631611699
2067,MADISON,137,Ila,812,949,0.855637513172
1987,LANIER,56,Stockton,332,388,0.855670103093
350,CHATTOOGA,15,HAYWOOD,89,104,0.855769230769
1935,JACKSON,128,Hoschton,760,888,0.855855855856
2563,WALTON,103,Whatley,612,715,0.855944055944
163,BULLOCH,42,Sinkhole,250,292,0.856164383562
1789,HALL,327,08-Morgan I,1948,2275,0.856263736264
1596,GORDON,112,RESACA,668,780,0.85641025641
2660,WILCOX,99,Rochelle South 4,591,690,0.85652173913
237,CATOOSA,143,BLACKSTOCK,854,997,0.856569709127
1996,LAURENS,68,Cadwell,407,475,0.856842105263
2234,PAULDING,390,CARL SCOGGINS MID SC,2342,2732,0.857247437775
1593,GORDON,141,LILY POND,847,988,0.857287449393
2553,WALKER,522,ROCK SPRING,3137,3659,0.857338070511
721,COWETA,172,PINE ROAD,1040,1212,0.858085808581
218,CARROLL,191,HULETT (1542),1156,1347,0.858203414996
2545,UNION,179,Gumlog,1084,1263,0.858273950911
2040,LONG,63,Tibet,382,445,0.858426966292
2092,MERIWETHER,43,CHALYBEATE,262,305,0.859016393443
1602,GRADY,27,Limesink,165,192,0.859375
2409,SPALDING,151,CABIN,926,1077,0.859795728877
1921,IRWIN,56,Mystic,344,400,0.86
1884,HENRY,210,UNITY GROVE - 10,1291,1501,0.860093271153
2562,WALTON,410,Bold Springs,2521,2931,0.860116001365
1106,FANNIN,93,MOBILE,573,666,0.86036036036
2295,RANDOLPH,12,4th District,74,86,0.860465116279
2282,PUTNAM,105,106,649,754,0.86074270557
2574,WALTON,361,Broken Arrow,2234,2595,0.860886319846
2564,WALTON,312,Walker Park,1931,2243,0.860900579581
361,CHEROKEE,268,AVERY,1661,1929,0.861067910835
2254,PICKENS,68,TATE - 09,423,491,0.86150712831
1060,EFFINGHAM,81,1B-12,504,585,0.861538461538
2013,LEE,110,SDA Church,687,797,0.861982434128
2491,TIFT,208,Brighton,1301,1509,0.862160371107
1932,JACKSON,80,Cunningham,501,581,0.86230636833
2389,SCREVEN,75,Bay Branch,470,545,0.862385321101
14,ATKINSON,135,Pearson County,846,981,0.862385321101
2573,WALTON,374,West Walton,2350,2724,0.862701908957
2275,POLK,248,LAKE CREEK,1564,1812,0.863134657837
1189,FORSYTH,175,16 Otwell-9,1108,1283,0.863600935308
716,COOK,105,New Life Bapt. Church,665,770,0.863636363636
752,CRAWFORD,128,3 - COUNTY,811,939,0.863684771033
2493,TIFT,128,Chula,813,941,0.863974495218
1777,HABERSHAM,375,Demorest,2383,2758,0.864031907179
2250,PICKENS,118,NELSON,750,868,0.864055299539
1854,HEARD,140,CENTRALHATCHEE,891,1031,0.864209505335
1073,EFFINGHAM,190,4C,1212,1402,0.864479315264
1179,FORSYTH,540,04 Chestatee,3445,3985,0.864491844417
2148,MURRAY,214,SOUTHWEST,1368,1582,0.864728192162
391,CHEROKEE,204,SUTALLEE,1305,1509,0.864811133201
766,DADE,210,TRENTON,1345,1555,0.864951768489
1950,JEFF DAVIS,113,Ocmulgee 1,724,837,0.864994026284
2119,MONROE,92,BRANTLEYS,590,682,0.865102639296
2146,MURRAY,175,MCDONALD,1123,1298,0.865177195686
1780,HABERSHAM,322,Mud Creek,2073,2395,0.865553235908
653,COLQUITT,75,Lee,483,558,0.865591397849
1105,FANNIN,143,MINERAL BLUFF,921,1064,0.865601503759
1057,ECHOLS,156,Statenville,1006,1162,0.865748709122
2582,WALTON,149,Good Hope,962,1111,0.865886588659
2435,SUMTER,35,Concord,226,261,0.865900383142
1158,FLOYD,76,FOSTER'S MILL,491,567,0.865961199295
43,BANKS,67,Baldwin,433,500,0.866
2151,MURRAY,151,CARTERS-DOOLITTLE,979,1130,0.866371681416
1172,FLOYD,262,WATTERS,1699,1961,0.866394696583
1936,JACKSON,96,Talmo,623,719,0.866481223922
84,BARTOW,204,WHITE,1326,1530,0.866666666667
2143,MORGAN,63,Clacks Chapel,412,475,0.867368421053
2071,MADISON,87,Poca,569,656,0.86737804878
770,DAWSON,607,East,3974,4581,0.867496179873
377,CHEROKEE,280,HIGHTOWER,1836,2116,0.867674858223
1999,LAURENS,148,Hampton Mill,975,1123,0.86821015138
349,CHATTOOGA,16,DIRTSELLER,106,122,0.868852459016
2530,TURNER,39,Rebecca,259,298,0.869127516779
2454,TATTNALL,84,District V,558,642,0.869158878505
1586,GORDON,131,PLAINVILLE,871,1002,0.869261477046
2068,MADISON,126,Mill,838,964,0.869294605809
1152,FLOYD,176,BARKERS,1172,1348,0.86943620178
649,COLQUITT,86,Funston,573,659,0.869499241275
1966,JOHNSON,64,Smith,427,491,0.869653767821
137,BROOKS,58,Nankin,387,445,0.869662921348
93,BERRIEN,77,Enigma,515,592,0.869932432432
225,CARROLL,150,WHITESBURG (682),1005,1155,0.87012987013
1959,JEFFERSON,31,Avera,208,239,0.870292887029
1568,GLYNN,194,Glyndale School,1302,1496,0.870320855615
671,COLUMBIA,160,Bessie Thomas Center,1074,1234,0.870340356564
771,DECATUR,56,Mt Pleasant,378,434,0.870967741935
1587,GORDON,388,SONORAVILLE,2622,3010,0.871096345515
1196,FRANKLIN,120,West Franklin,812,932,0.871244635193
1551,GILMER,82,TOWN CREEK,555,637,0.871271585557
1824,HARALSON,169,BUCHANAN,1153,1322,0.872163388805
2292,RANDOLPH,30,Carnegie,205,235,0.872340425532
1930,JACKSON,187,Newtown,1287,1474,0.873134328358
156,BULLOCH,68,Leefield,471,539,0.873840445269
362,CHEROKEE,280,BALL GROUND,1940,2220,0.873873873874
2575,WALTON,262,Bay Creek,1816,2078,0.873917228104
2659,WILCOX,69,Pitts 3,479,548,0.874087591241
1549,GILMER,124,CARTECAY,861,985,0.874111675127
1550,GILMER,113,TAILS CREEK,785,898,0.87416481069
2061,MADISON,46,Collins,321,367,0.874659400545
1861,HENRY,263,TUSSAHAW,1838,2101,0.874821513565
2567,WALTON,191,Walnut Grove,1337,1528,0.875
1934,JACKSON,66,Wilson,466,532,0.875939849624
1199,FRANKLIN,86,Canon,608,694,0.876080691643
2623,WHITE,60,Blue Ridge,425,485,0.876288659794
717,COOK,99,Riverbend,703,802,0.876558603491
1834,HARALSON,74,WACO,526,600,0.876666666667
2581,WALTON,89,Blasingame,634,723,0.876901798064
1929,JACKSON,484,Randolph,3454,3938,0.877094972067
53,BANKS,48,Washington,343,391,0.877237851662
2641,WHITFIELD,118,MC,845,963,0.877466251298
2589,WARE,30,404,215,245,0.877551020408
252,CHARLTON,59,Homeland,423,482,0.877593360996
2688,WORTH,47,Shingler,337,384,0.877604166667
754,CRAWFORD,126,4,905,1031,0.877788554801
211,CARROLL,107,LOWELL (1163),769,876,0.877853881279
48,BANKS,57,Golden Hill,410,467,0.877944325482
2072,MARION,69,Pineknot,499,568,0.878521126761
210,CARROLL,128,CENTER POINT (1152),926,1054,0.878557874763
661,COLQUITT,68,Warrior,493,561,0.878787878788
2529,TURNER,126,Sycamore,916,1042,0.879078694818
2646,WHITFIELD,104,TR,759,863,0.879490150637
2268,PIKE,87,Lifsey Springs,635,722,0.879501385042
1794,HALL,219,13-Lula,1601,1820,0.87967032967
130,BRANTLEY,274,Nahunta,2018,2292,0.880453752182
2629,WHITE,153,Shoal Creek,1127,1280,0.88046875
1942,JASPER,248,MARTIN & BURNEY,1836,2084,0.880998080614
2413,SPALDING,170,COUNTY LINE,1260,1430,0.881118881119
1857,HEARD,85,EPHESUS,631,716,0.881284916201
0,APPLING,92,1B,684,776,0.881443298969
2245,PICKENS,169,REFUGE,1259,1428,0.881652661064
185,BUTTS,144,WORTHVILLE,1075,1219,0.881870385562
987,DODGE,17,Yonker,127,144,0.881944444444
2647,WHITFIELD,67,UT,501,568,0.882042253521
161,BULLOCH,98,Bay,734,832,0.882211538462
2588,WARE,248,400,1861,2109,0.882408724514
2492,TIFT,104,Brookfield,781,885,0.882485875706
10,APPLING,83,4D,624,707,0.882602545969
2400,SEMINOLE,83,Precinct 5,624,707,0.882602545969
386,CHEROKEE,227,R M MOORE,1708,1935,0.882687338501
659,COLQUITT,17,Thigpen,128,145,0.88275862069
1113,FAYETTE,194,BROOKS,1468,1662,0.883273164862
1170,FLOYD,61,TEXAS VALLEY,462,523,0.883365200765
2069,MADISON,19,Paoli,145,164,0.884146341463
2115,MITCHELL,14,Pebble City,107,121,0.884297520661
2462,TELFAIR,62,Milan,474,536,0.884328358209
50,BANKS,48,Hollingsworth,368,416,0.884615384615
2195,NEWTON,114,Mansfield,877,991,0.884964682139
1588,GORDON,63,PINE CHAPEL,487,550,0.885454545455
764,DADE,45,NEW HOME,348,393,0.885496183206
977,DODGE,33,Jones,256,289,0.885813148789
1855,HEARD,33,COOKSVILLE - CORINTH,256,289,0.885813148789
2631,WHITE,99,Town Creek,768,867,0.885813148789
2269,PIKE,118,Williamson,917,1035,0.885990338164
983,DODGE,33,Plainfield,257,290,0.886206896552
11,APPLING,68,5A,530,598,0.886287625418
2277,POLK,128,YOUNGS GROVE,1001,1129,0.886625332152
650,COLQUITT,51,Hamilton,399,450,0.886666666667
2503,TOOMBS,92,39 New Branch,720,812,0.886699507389
47,BANKS,103,Davids,820,923,0.888407367281
1807,HALL,77,26-Gillsville,614,691,0.888567293777
354,CHATTOOGA,40,TELOGA,320,360,0.888888888889
131,BRANTLEY,210,Waynesville,1682,1892,0.889006342495
2640,WHITFIELD,76,LT,610,686,0.889212827988
2248,PICKENS,67,JERUSALEM,538,605,0.889256198347
2152,MURRAY,134,NORTH,1084,1218,0.889983579639
2075,MARION,33,Brantley,268,301,0.890365448505
763,DADE,119,DAVIS,967,1086,0.890423572744
2133,MONTGOMERY,36,Alston,293,329,0.890577507599
2495,TIFT,79,Eldorado,643,722,0.890581717452
1607,GRADY,41,Spring Hill,335,376,0.890957446809
663,COLUMBIA,125,Kiokee Baptist Church-12,1022,1147,0.89102005231
1157,FLOYD,119,FLOYD SPRINGS,974,1093,0.891125343092
2511,TREUTLEN,146,Annex,1198,1344,0.891369047619
1944,JEFF DAVIS,50,Altamaha 1,412,462,0.891774891775
1062,EFFINGHAM,122,1D,1006,1128,0.891843971631
82,BARTOW,131,PINE LOG,1082,1213,0.892003297609
2256,PIERCE,188,Blackshear,1556,1744,0.892201834862
1558,GILMER,78,YUKON,646,724,0.89226519337
2267,PIKE,178,Second District,1481,1659,0.892706449668
2625,WHITE,182,Mossy Creek,1517,1699,0.892878163626
2415,SPALDING,44,BLALOCK,368,412,0.893203883495
1829,HARALSON,46,LITTLE CREEK,386,432,0.893518518519
1808,HALL,257,27-Big Hickory,2157,2414,0.893537696769
755,CRAWFORD,110,5,926,1036,0.893822393822
488,CLINCH,7,Arabia,59,66,0.893939393939
1195,FRANKLIN,144,Carnesville,1216,1360,0.894117647059
680,COLUMBIA,68,Damascus Baptist Church,576,644,0.894409937888
2265,PIKE,90,Meansville,765,855,0.894736842105
253,CHARLTON,48,Folkston Fire,411,459,0.895424836601
2683,WORTH,94,Isabella,806,900,0.895555555556
2606,WAYNE,110,Oglethorpe,945,1055,0.895734597156
1918,IRWIN,27,Roberts,232,259,0.895752895753
2247,PICKENS,47,HINTON,404,451,0.89578713969
2078,MCDUFFIE,101,Augusta Tech,871,972,0.896090534979
2494,TIFT,76,Docia,658,734,0.896457765668
1084,ELBERT,36,Gaines,312,348,0.896551724138
2552,WALKER,124,CENTER POST,1083,1207,0.897265948633
389,CHEROKEE,43,SALACOA,376,419,0.897374701671
2105,MERIWETHER,16,COVE,140,156,0.897435897436
42,BANKS,84,Anderson,736,820,0.89756097561
1585,GORDON,84,SUGAR VALLEY,737,821,0.897685749086
1825,HARALSON,52,BUNCOMBE,459,511,0.898238747554
2253,PICKENS,105,TATE - 14,935,1040,0.899038461538
2673,WILKINSON,55,Ivey,490,545,0.899082568807
1562,GLASCOCK,46,Gibson,410,456,0.899122807018
2612,WAYNE,42,Gardi,376,418,0.8995215311
656,COLQUITT,62,Murphy,558,620,0.9
2251,PICKENS,103,TALKING ROCK,933,1036,0.900579150579
646,COLQUITT,76,Bridgecreek,689,765,0.900653594771
654,COLQUITT,27,Millcreek,245,272,0.900735294118
1161,FLOYD,89,HOWELL,810,899,0.901001112347
2009,LEE,42,CJC,387,429,0.902097902098
1933,JACKSON,114,Miller,1055,1169,0.90248075278
1594,GORDON,104,FAIRMOUNT,966,1070,0.902803738318
51,BANKS,80,Homer,744,824,0.902912621359
83,BARTOW,159,TAYLORSVILLE,1479,1638,0.90293040293
2135,MONTGOMERY,33,Kibbee,307,340,0.902941176471
2065,MADISON,35,Harrison,326,361,0.903047091413
2618,WAYNE,9,East Jesup,84,93,0.903225806452
372,CHEROKEE,45,CONNS CREEK,424,469,0.904051172708
759,CRISP,78,Jamestown,735,813,0.90405904059
757,CRISP,61,Coney,576,637,0.904238618524
1201,FRANKLIN,132,SouthWest Franklin,1258,1390,0.905035971223
2113,MITCHELL,11,Hisonton,105,116,0.905172413793
1796,HALL,160,15-Quillians,1528,1688,0.905213270142
662,COLUMBIA,52,Kiokee Baptist Church-10,502,554,0.906137184116
2690,WORTH,26,Doles,252,278,0.906474820144
1827,HARALSON,40,TWENTIETH,389,429,0.90675990676
2565,WALTON,77,Gratis,757,834,0.907673860911
357,CHATTOOGA,30,SUBLIGNA,295,325,0.907692307692
769,DAWSON,474,Central,4674,5148,0.907925407925
975,DODGE,23,Empire,229,252,0.90873015873
2504,TOOMBS,71,43 Cedar Crossing,716,787,0.909783989835
2604,WAYNE,72,Odum,731,803,0.910336239103
183,BUTTS,163,STARK,1657,1820,0.91043956044
1949,JEFF DAVIS,38,Whitehead 2,387,425,0.910588235294
1606,GRADY,40,Spence,410,450,0.911111111111
13,APPLING,24,5C,247,271,0.911439114391
2264,PIKE,97,Hollonville,1001,1098,0.911657559199
491,CLINCH,15,Fargo,156,171,0.912280701754
2260,PIERCE,26,Mershon,273,299,0.913043478261
1826,HARALSON,78,CORINTH,821,899,0.913236929922
2258,PIERCE,71,Otter Creek,754,825,0.913939393939
52,BANKS,79,Poplar Springs,839,918,0.91394335512
46,BANKS,21,Columbia,224,245,0.914285714286
251,CHARLTON,42,American Legion,450,492,0.914634146341
973,DODGE,5,Clark,54,59,0.915254237288
1917,IRWIN,17,Minnie,184,201,0.915422885572
2261,PIERCE,47,Alabaha,511,558,0.915770609319
1795,HALL,166,14-Clermont,1818,1984,0.916330645161
2591,WARE,84,406,927,1011,0.916913946588
44,BANKS,17,Berlin,188,205,0.917073170732
2594,WARE,50,409,554,604,0.917218543046
2632,WHITE,83,White Creek,926,1009,0.917740336967
2580,WALTON,98,Jersey,1101,1199,0.918265221018
54,BANKS,30,Wilmonts,342,372,0.91935483871
651,COLQUITT,23,Hartsfield,265,288,0.920138888889
660,COLQUITT,22,Tyty,254,276,0.920289855072
79,BARTOW,60,FOLSOM,697,757,0.920739762219
1968,JOHNSON,48,Kite,559,607,0.920922570016
2111,MITCHELL,21,Cotton,245,266,0.921052631579
2257,PIERCE,77,St Johns/Blackshear,905,982,0.921588594705
1828,HARALSON,13,FELTON,153,166,0.921686746988
207,CARROLL,51,KANSAS (1006),601,652,0.921779141104
1,APPLING,42,1C,496,538,0.921933085502
2593,WARE,24,408,286,310,0.922580645161
19,BACON,58,New Lacy,696,754,0.923076923077
2680,WORTH,26,Minton,313,339,0.923303834808
642,COFFEE,45,West Green,548,593,0.924114671164
250,CHARLTON,32,St. George,392,424,0.924528301887
45,BANKS,29,Bushville,374,403,0.928039702233
15,ATKINSON,29,Axson,375,404,0.928217821782
2137,MONTGOMERY,16,Tarrytown,207,223,0.928251121076
90,BERRIEN,48,West Berrien,625,673,0.92867756315
21,BACON,25,Ware,328,353,0.929178470255
22,BACON,18,Warnock,241,259,0.930501930502
1916,IRWIN,37,Irwinville,499,536,0.930970149254
2609,WAYNE,46,Empire,623,669,0.931240657698
255,CHARLTON,14,Winokur,191,205,0.931707317073
129,BRANTLEY,135,Hoboken,1861,1996,0.932364729459
254,CHARLTON,12,Racepond,167,179,0.932960893855
1832,HARALSON,23,BEREA-STEADMAN,323,346,0.933526011561
1947,JEFF DAVIS,30,Blackburn 2,422,452,0.933628318584
1830,HARALSON,12,MT VIEW,170,182,0.934065934066
2249,PICKENS,24,LUDVILLE,343,367,0.934604904632
2590,WARE,25,405,358,383,0.934725848564
1563,GLASCOCK,33,Mill,473,506,0.934782608696
760,CRISP,34,Listonia,495,529,0.93572778828
49,BANKS,21,Grove River,309,330,0.936363636364
1561,GLASCOCK,6,Edgehill,90,96,0.9375
2001,LAURENS,34,Minter,516,550,0.938181818182
2679,WORTH,22,Scooterville,337,359,0.938718662953
356,CHATTOOGA,5,SEMINOLE,77,82,0.939024390244
249,CHARLTON,17,GA Bend,272,289,0.941176470588
2592,WARE,18,407,300,318,0.943396226415
1088,EMANUEL,21,Oak Park,351,372,0.943548387097
1185,FORSYTH,1,10 Midway-9,17,18,0.944444444444
2613,WAYNE,12,Mt. Pleasant,204,216,0.944444444444
2605,WAYNE,40,Madray Springs,681,721,0.94452149792
2669,WILKINSON,15,Bloodworth,256,271,0.944649446494
20,BACON,30,Taylor,520,550,0.945454545455
7,APPLING,14,4A,261,275,0.949090909091
4,APPLING,17,3A1,319,336,0.949404761905
1945,JEFF DAVIS,43,Altamaha 2,819,862,0.950116009281
1093,EMANUEL,22,Blundale,466,488,0.954918032787
9,APPLING,10,4C,284,294,0.965986394558
986,DODGE,4,Vilula,121,125,0.968
1922,IRWIN,8,Fletcher,246,254,0.968503937008
8,APPLING,7,4B,305,312,0.977564102564
2608,WAYNE,5,Ritch,219,224,0.977678571429
2262,PIERCE,4,Sunset/Sweat,189,193,0.979274611399
3,APPLING,4,3A,208,212,0.981132075472
