,county,dem_votes,precinct,rep_votes,total,rep_p,dem_p
0,CLAYTON,3156,ELLENWOOD,218,3374,0.0646117368109,0.935388263189
1,CLAYTON,1011,FOREST PARK 1,265,1276,0.207680250784,0.792319749216
2,CLAYTON,953,FOREST PARK 2,183,1136,0.161091549296,0.838908450704
3,CLAYTON,877,FOREST PARK 3,222,1099,0.202001819836,0.797998180164
4,CLAYTON,569,FOREST PARK 4,282,851,0.331374853114,0.668625146886
5,CLAYTON,1257,FOREST PARK 5,263,1520,0.173026315789,0.826973684211
6,CLAYTON,456,FOREST PARK 6,204,660,0.309090909091,0.690909090909
7,CLAYTON,2160,JONESBORO 1,207,2367,0.0874524714829,0.912547528517
8,CLAYTON,2014,JONESBORO 2,108,2122,0.0508953817154,0.949104618285
9,CLAYTON,1787,JONESBORO 3,384,2171,0.1768770152,0.8231229848
10,CLAYTON,805,JONESBORO 4,172,977,0.17604912999,0.82395087001
11,CLAYTON,820,JONESBORO 5,269,1089,0.247015610652,0.752984389348
12,CLAYTON,836,JONESBORO 6,840,1676,0.501193317422,0.498806682578
13,CLAYTON,1382,JONESBORO 7,328,1710,0.191812865497,0.808187134503
14,CLAYTON,1562,JONESBORO 8,115,1677,0.0685748360167,0.931425163983
15,CLAYTON,470,JONESBORO 9,131,601,0.217970049917,0.782029950083
16,CLAYTON,1221,JONESBORO 10,158,1379,0.11457577955,0.88542422045
17,CLAYTON,1656,JONESBORO 11,483,2139,0.225806451613,0.774193548387
18,CLAYTON,1322,JONESBORO 12,109,1431,0.0761705101328,0.923829489867
19,CLAYTON,946,JONESBORO 13,182,1128,0.16134751773,0.83865248227
20,CLAYTON,1763,JONESBORO 14,854,2617,0.326327856324,0.673672143676
21,CLAYTON,1047,JONESBORO 15,128,1175,0.108936170213,0.891063829787
22,CLAYTON,905,JONESBORO 16,126,1031,0.122211445199,0.877788554801
23,CLAYTON,2141,JONESBORO 17,164,2305,0.0711496746204,0.92885032538
24,CLAYTON,1340,JONESBORO 18,206,1546,0.133247089263,0.866752910737
25,CLAYTON,1173,LAKE CITY,154,1327,0.116051243406,0.883948756594
26,CLAYTON,1771,LOVEJOY 1,313,2084,0.15019193858,0.84980806142
27,CLAYTON,1411,LOVEJOY 2,196,1607,0.121966397013,0.878033602987
28,CLAYTON,2676,LOVEJOY 3,572,3248,0.176108374384,0.823891625616
29,CLAYTON,2014,LOVEJOY 4,232,2246,0.103294746215,0.896705253785
30,CLAYTON,1363,LOVEJOY 5,147,1510,0.0973509933775,0.902649006623
31,CLAYTON,1314,MORROW 1,128,1442,0.0887656033287,0.911234396671
32,CLAYTON,678,MORROW 2,338,1016,0.332677165354,0.667322834646
33,CLAYTON,1823,MORROW 3,337,2160,0.156018518519,0.843981481481
34,CLAYTON,725,MORROW 4,234,959,0.244004171011,0.755995828989
35,CLAYTON,2415,MORROW 5,407,2822,0.144223954642,0.855776045358
36,CLAYTON,1203,MORROW 6,243,1446,0.168049792531,0.831950207469
37,CLAYTON,756,MORROW 7,160,916,0.174672489083,0.825327510917
38,CLAYTON,1457,MORROW 8,114,1571,0.0725652450668,0.927434754933
39,CLAYTON,607,MORROW 9,112,719,0.155771905424,0.844228094576
40,CLAYTON,1082,OAK 1,36,1118,0.0322003577818,0.967799642218
41,CLAYTON,693,OAK 2,41,734,0.0558583106267,0.944141689373
42,CLAYTON,1689,OAK 3,67,1756,0.0381548974943,0.961845102506
43,CLAYTON,1627,OAK 4,59,1686,0.0349940688019,0.965005931198
44,CLAYTON,1548,PANHANDLE 1,217,1765,0.122946175637,0.877053824363
45,CLAYTON,1204,PANHANDLE 2,456,1660,0.274698795181,0.725301204819
46,CLAYTON,1234,RIVERDALE 1,106,1340,0.0791044776119,0.920895522388
47,CLAYTON,1573,RIVERDALE 2,76,1649,0.0460885385082,0.953911461492
48,CLAYTON,1674,RIVERDALE 3,86,1760,0.0488636363636,0.951136363636
49,CLAYTON,1738,RIVERDALE 4,192,1930,0.099481865285,0.900518134715
50,CLAYTON,1409,RIVERDALE 5,108,1517,0.0711931443639,0.928806855636
51,CLAYTON,1213,RIVERDALE 6,195,1408,0.138494318182,0.861505681818
52,CLAYTON,895,RIVERDALE 7,134,1029,0.130223517979,0.869776482021
53,CLAYTON,1468,RIVERDALE 8,159,1627,0.0977258758451,0.902274124155
54,CLAYTON,1225,RIVERDALE 9,146,1371,0.106491611962,0.893508388038
55,CLAYTON,1144,RIVERDALE 10,43,1187,0.0362257792755,0.963774220725
56,CLAYTON,982,RIVERDALE 11,60,1042,0.0575815738964,0.942418426104
57,CLAYTON,1497,RIVERDALE 12,110,1607,0.0684505289359,0.931549471064
58,COBB,1363,ACWORTH 1A,1721,3084,0.55804150454,0.44195849546
59,COBB,1152,ACWORTH 1B,1607,2759,0.582457412106,0.417542587894
60,COBB,1532,ACWORTH 1C,1037,2569,0.403659011288,0.596340988712
61,COBB,681,ADDISON 01,898,1579,0.568714376187,0.431285623813
62,COBB,1995,AUSTELL 1A,523,2518,0.207704527403,0.792295472597
63,COBB,792,BELLS FERRY 02,1041,1833,0.567921440262,0.432078559738
64,COBB,1357,BELLS FERRY 03,2108,3465,0.608369408369,0.391630591631
65,COBB,667,BIG SHANTY 01,887,1554,0.570785070785,0.429214929215
66,COBB,805,BIG SHANTY 02,1185,1990,0.595477386935,0.404522613065
67,COBB,1460,BAKER 01,1257,2717,0.462642620537,0.537357379463
68,COBB,899,BIRNEY 01,558,1457,0.382978723404,0.617021276596
69,COBB,1441,BIRNEY 02,922,2363,0.390181972069,0.609818027931
70,COBB,1190,BRYANT 01,74,1264,0.0585443037975,0.941455696203
71,COBB,2450,BRYANT 02,140,2590,0.0540540540541,0.945945945946
72,COBB,767,BLACKWELL 01,875,1642,0.532886723508,0.467113276492
73,COBB,2134,CHATTAHOOCHEE 01,780,2914,0.267673301304,0.732326698696
74,COBB,702,CHEATHAM HILL 02,1298,2000,0.649,0.351
75,COBB,1117,CHEATHAM HILL 03,1507,2624,0.57431402439,0.42568597561
76,COBB,1468,CHALKER 01,1282,2750,0.466181818182,0.533818181818
77,COBB,666,CLARKDALE 01,448,1114,0.402154398564,0.597845601436
78,COBB,2063,CLARKDALE 02,981,3044,0.322273324573,0.677726675427
79,COBB,1998,COOPER 01,625,2623,0.23827678231,0.76172321769
80,COBB,809,CHESTNUT RIDGE 01,1410,2219,0.635421360973,0.364578639027
81,COBB,823,DICKERSON 01,1145,1968,0.581808943089,0.418191056911
82,COBB,1638,DOBBINS 01,400,2038,0.196270853778,0.803729146222
83,COBB,973,DOWELL 01,1059,2032,0.521161417323,0.478838582677
84,COBB,553,DODGEN 01,929,1482,0.62685560054,0.37314439946
85,COBB,718,DURHAM 01,2056,2774,0.741167988464,0.258832011536
86,COBB,502,DAVIS 01,803,1305,0.615325670498,0.384674329502
87,COBB,832,EASTSIDE 01,1231,2063,0.596703829375,0.403296170625
88,COBB,1115,EASTSIDE 02,1651,2766,0.596890817064,0.403109182936
89,COBB,1240,ELIZABETH 01,685,1925,0.355844155844,0.644155844156
90,COBB,617,ELIZABETH 02,961,1578,0.608998732573,0.391001267427
91,COBB,723,ELIZABETH 03,1138,1861,0.611499193982,0.388500806018
92,COBB,928,ELIZABETH 04,709,1637,0.433109346365,0.566890653635
93,COBB,860,ELIZABETH 05,1071,1931,0.554634904195,0.445365095805
94,COBB,733,EAST PIEDMONT 01,694,1427,0.486334968465,0.513665031535
95,COBB,1564,FAIR OAKS 01,603,2167,0.278264882326,0.721735117674
96,COBB,1617,FAIR OAKS 02,588,2205,0.266666666667,0.733333333333
97,COBB,738,FAIR OAKS 04,436,1174,0.371379897785,0.628620102215
98,COBB,542,FAIR OAKS 05,297,839,0.353992848629,0.646007151371
99,COBB,982,FULLERS PARK 01,1274,2256,0.564716312057,0.435283687943
100,COBB,557,FORD 01,1562,2119,0.737140160453,0.262859839547
101,COBB,511,FREY 01,1115,1626,0.685731857319,0.314268142681
102,COBB,759,GARRISON MILL 01,1119,1878,0.595846645367,0.404153354633
103,COBB,960,GRITTERS 01,1472,2432,0.605263157895,0.394736842105
104,COBB,2753,HARMONY LELAND 01,646,3399,0.190055898794,0.809944101206
105,COBB,491,HARRISON 01,1412,1903,0.741986337362,0.258013662638
106,COBB,1146,HIGHTOWER 01,1713,2859,0.599160545645,0.400839454355
107,COBB,789,HAYES 01,1796,2585,0.694777562863,0.305222437137
108,COBB,652,KENNESAW 1A,688,1340,0.513432835821,0.486567164179
109,COBB,936,KENNESAW 2A,1250,2186,0.571820677036,0.428179322964
110,COBB,1899,KENNESAW 3A,1227,3126,0.392514395393,0.607485604607
111,COBB,1002,KENNESAW 4A,1155,2157,0.535465924896,0.464534075104
112,COBB,1708,KENNESAW 5A,1788,3496,0.511441647597,0.488558352403
113,COBB,461,KELL 01,840,1301,0.645657186779,0.354342813221
114,COBB,335,KEMP 01,943,1278,0.737871674491,0.262128325509
115,COBB,978,KEMP 02,1643,2621,0.626859977108,0.373140022892
116,COBB,633,KEMP 03,2032,2665,0.762476547842,0.237523452158
117,COBB,843,LASSSITER 01,1606,2449,0.655777868518,0.344222131482
118,COBB,2170,LINDLEY 01,796,2966,0.268374915711,0.731625084289
119,COBB,738,LOST MOUNTAIN 01,1567,2305,0.679826464208,0.320173535792
120,COBB,680,LOST MOUNTAIN 02,2112,2792,0.756446991404,0.243553008596
121,COBB,1081,LOST MOUNTAIN 03,2342,3423,0.684195150453,0.315804849547
122,COBB,558,LOST MOUNTAIN 04,1238,1796,0.689309576837,0.310690423163
123,COBB,324,LEWIS 01,769,1093,0.703568161025,0.296431838975
124,COBB,1794,MABLETON 01,982,2776,0.353746397695,0.646253602305
125,COBB,948,MABLETON 02,503,1451,0.346657477602,0.653342522398
126,COBB,903,MABLETON 03,829,1732,0.478637413395,0.521362586605
127,COBB,468,MABLETON 04,536,1004,0.533864541833,0.466135458167
128,COBB,392,MABRY 01,797,1189,0.67031118587,0.32968881413
129,COBB,1554,MACLAND 01,740,2294,0.322580645161,0.677419354839
130,COBB,1035,MURDOCK 01,1611,2646,0.608843537415,0.391156462585
131,COBB,1102,MCEACHERN 01,1002,2104,0.476235741445,0.523764258555
132,COBB,442,MCCLESKEY 01,752,1194,0.629815745394,0.370184254606
133,COBB,326,MCCLURE 01,747,1073,0.696178937558,0.303821062442
134,COBB,1176,MARIETTA 1A,497,1673,0.297071129707,0.702928870293
135,COBB,536,MARIETTA 2A,948,1484,0.638814016173,0.361185983827
136,COBB,1491,MARIETTA 2B,1069,2560,0.417578125,0.582421875
137,COBB,2095,MARIETTA 3A,1499,3594,0.417084028937,0.582915971063
138,COBB,372,MARIETTA 4A,1008,1380,0.730434782609,0.269565217391
139,COBB,614,MARIETTA 4B,623,1237,0.503637833468,0.496362166532
140,COBB,648,MARIETTA 4C,1231,1879,0.655135710484,0.344864289516
141,COBB,1244,MARIETTA 5A,378,1622,0.233045622688,0.766954377312
142,COBB,905,MARIETTA 5B,290,1195,0.242677824268,0.757322175732
143,COBB,908,MARIETTA 6A,307,1215,0.252674897119,0.747325102881
144,COBB,924,MARIETTA 6B,913,1837,0.497005988024,0.502994011976
145,COBB,1206,MARIETTA 7A,273,1479,0.184584178499,0.815415821501
146,COBB,472,MARS HILL 01,1638,2110,0.776303317536,0.223696682464
147,COBB,646,MARS HILL 02,1027,1673,0.613867304244,0.386132695756
148,COBB,1172,MOUNT BETHEL 01,1668,2840,0.587323943662,0.412676056338
149,COBB,956,MOUNT BETHEL 03,1181,2137,0.552643893308,0.447356106692
150,COBB,805,MOUNT BETHEL 04,1237,2042,0.605778648384,0.394221351616
151,COBB,593,NORTH COBB 01,785,1378,0.569666182874,0.430333817126
152,COBB,2088,NICKAJACK 01,703,2791,0.25188104622,0.74811895378
153,COBB,1410,NORTON PARK 01,1074,2484,0.432367149758,0.567632850242
154,COBB,570,NICHOLSON 01,976,1546,0.631306597671,0.368693402329
155,COBB,1378,OAKDALE 01,1083,2461,0.440065014222,0.559934985778
156,COBB,387,OREGON 01,762,1149,0.66318537859,0.33681462141
157,COBB,2300,OREGON 02,858,3158,0.271690943635,0.728309056365
158,COBB,1179,OREGON 03,576,1755,0.328205128205,0.671794871795
159,COBB,1772,OREGON 04,724,2496,0.290064102564,0.709935897436
160,COBB,1277,OREGON 05,1128,2405,0.469022869023,0.530977130977
161,COBB,2283,PEBBLEBROOK 01,500,2783,0.179662234998,0.820337765002
162,COBB,959,POWERS FERRY 01,1098,2057,0.533787068546,0.466212931454
163,COBB,685,PINE MOUNTAIN 01,1605,2290,0.700873362445,0.299126637555
164,COBB,501,PINE MOUNTAIN 02,1597,2098,0.761201143947,0.238798856053
165,COBB,849,POST OAK 01,1629,2478,0.657384987893,0.342615012107
166,COBB,797,POPE 01,1316,2113,0.622811168954,0.377188831046
167,COBB,587,PALMER 01,1042,1629,0.639656230816,0.360343769184
168,COBB,1633,POWDER SPRINGS 1A,925,2558,0.361610633307,0.638389366693
169,COBB,1450,POWDER SPRINGS 2A,415,1865,0.222520107239,0.777479892761
170,COBB,1448,POWDER SPRINGS 3A,622,2070,0.300483091787,0.699516908213
171,COBB,647,PITNER 01,1087,1734,0.626874279123,0.373125720877
172,COBB,852,ROCKY MOUNTAIN 01,1381,2233,0.618450515002,0.381549484998
173,COBB,905,RIVERSIDE 01,84,989,0.0849342770475,0.915065722952
174,COBB,1534,ROSWELL 01,2292,3826,0.599059069524,0.400940930476
175,COBB,1041,ROSWELL 02,1450,2491,0.582095543958,0.417904456042
176,COBB,849,SANDY PLAINS 01,1048,1897,0.552451238798,0.447548761202
177,COBB,916,SHALLOWFORD FALL 01,1401,2317,0.604661199827,0.395338800173
178,COBB,533,SIMPSON 01,766,1299,0.589684372594,0.410315627406
179,COBB,976,SEWELL MILL 01,1270,2246,0.565449688335,0.434550311665
180,COBB,1372,SEWELL MILL 03,1208,2580,0.468217054264,0.531782945736
181,COBB,1589,SMYRNA 1A,485,2074,0.233847637416,0.766152362584
182,COBB,2199,SMYRNA 2A,785,2984,0.263069705094,0.736930294906
183,COBB,2241,SMYRNA 3A,1373,3614,0.379911455451,0.620088544549
184,COBB,2065,SMYRNA 4A,1765,3830,0.460835509138,0.539164490862
185,COBB,1360,SMYRNA 5A,681,2041,0.333659970603,0.666340029397
186,COBB,2161,SMYRNA 6A,1635,3796,0.43071654373,0.56928345627
187,COBB,2622,SMYRNA 7A,1358,3980,0.341206030151,0.658793969849
188,COBB,583,SOPE CREEK 01,977,1560,0.626282051282,0.373717948718
189,COBB,1355,SOPE CREEK 02,1486,2841,0.523055262232,0.476944737768
190,COBB,721,SOPE CREEK 03,1225,1946,0.629496402878,0.370503597122
191,COBB,1147,SWEETWATER 01,897,2044,0.438845401174,0.561154598826
192,COBB,1137,SWEETWATER 02,382,1519,0.251481237656,0.748518762344
193,COBB,1982,TERRELL MILL 01,869,2851,0.304805331463,0.695194668537
194,COBB,767,TIMBER RIDGE 01,1000,1767,0.565930956423,0.434069043577
195,COBB,598,VAUGHN 01,1538,2136,0.720037453184,0.279962546816
196,COBB,859,VININGS 01,584,1443,0.404712404712,0.595287595288
197,COBB,2238,VININGS 02,1221,3459,0.352992194276,0.647007805724
198,COBB,1598,VININGS 03,991,2589,0.382773271533,0.617226728467
199,COBB,1008,VININGS 04,1270,2278,0.557506584723,0.442493415277
200,COBB,1361,WADE GREEN 02,1410,2771,0.508841573439,0.491158426561
201,COBB,750,WILEO 01,1254,2004,0.625748502994,0.374251497006
202,DEKALB,1571,ALLGOOD ELEM,172,1743,0.0986804360298,0.90131956397
203,DEKALB,1081,ASHFORD DUNWOODY RD,897,1978,0.453488372093,0.546511627907
204,DEKALB,782,ASHFORD PARK ELEM,809,1591,0.508485229415,0.491514770585
205,DEKALB,1400,ASHFORD PARKSIDE,954,2354,0.405267629567,0.594732370433
206,DEKALB,784,AUSTIN,1064,1848,0.575757575758,0.424242424242
207,DEKALB,1101,AUSTIN DRIVE,60,1161,0.0516795865633,0.948320413437
208,DEKALB,1483,AVONDALE,550,2033,0.270536153468,0.729463846532
209,DEKALB,949,AVONDALE HIGH,164,1113,0.14734950584,0.85265049416
210,DEKALB,847,AVONDALE HIGH,93,940,0.0989361702128,0.901063829787
211,DEKALB,2398,BETHUNE MIDDLE,78,2476,0.0315024232633,0.968497576737
212,DEKALB,1106,BOULDERCREST RD,53,1159,0.0457290767903,0.95427092321
213,DEKALB,2575,BOULEVARD,236,2811,0.0839558875845,0.916044112416
214,DEKALB,1364,BRIAR VISTA ELEM,408,1772,0.230248306998,0.769751693002
215,DEKALB,1193,BRIARCLIFF,686,1879,0.365087812666,0.634912187334
216,DEKALB,706,BRIARLAKE ELEM,486,1192,0.407718120805,0.592281879195
217,DEKALB,870,BRIARWOOD,513,1383,0.370932754881,0.629067245119
218,DEKALB,966,BROCKETT,584,1550,0.376774193548,0.623225806452
219,DEKALB,1042,BROCKETT ELEM,546,1588,0.343828715365,0.656171284635
220,DEKALB,1164,BROOKHAVEN,988,2152,0.459107806691,0.540892193309
221,DEKALB,2293,BROWNS MILL ELEM,80,2373,0.0337126000843,0.966287399916
222,DEKALB,1725,BURGESS ELEM,133,1858,0.0715823466093,0.928417653391
223,DEKALB,1081,CANBY LANE ELEM,31,1112,0.0278776978417,0.972122302158
224,DEKALB,1533,CANDLER,72,1605,0.0448598130841,0.955140186916
225,DEKALB,1695,CANDLER-MURPHEY CAND,133,1828,0.0727571115974,0.927242888403
226,DEKALB,2431,CEDAR GROVE ELEM,91,2522,0.0360824742268,0.963917525773
227,DEKALB,813,CEDAR GROVE MIDDLE,23,836,0.0275119617225,0.972488038278
228,DEKALB,2235,CEDAR GROVE SOUTH,75,2310,0.0324675324675,0.967532467532
229,DEKALB,631,CHAMBLEE,361,992,0.363911290323,0.636088709677
230,DEKALB,969,CHAMBLEE,686,1655,0.414501510574,0.585498489426
231,DEKALB,1907,CHAPEL HILL ELEM,49,1956,0.0250511247444,0.974948875256
232,DEKALB,932,CHESNUT ELEM,415,1347,0.308092056422,0.691907943578
233,DEKALB,1963,CLAIREMONT EAST,350,2313,0.151318633809,0.848681366191
234,DEKALB,1995,CLAIREMONT WEST,329,2324,0.14156626506,0.85843373494
235,DEKALB,1422,CLAIRMONT ROAD,425,1847,0.230102869518,0.769897130482
236,DEKALB,2387,CLARKSTON,230,2617,0.0878868933894,0.912113106611
237,DEKALB,919,CLIFTON ELEM,39,958,0.0407098121086,0.959290187891
238,DEKALB,1141,COLUMBIA DRIVE,37,1178,0.0314091680815,0.968590831919
239,DEKALB,744,COLUMBIA ELEM,8,752,0.0106382978723,0.989361702128
240,DEKALB,948,COLUMBIA MIDDLE,27,975,0.0276923076923,0.972307692308
241,DEKALB,1565,CORALWOOD,665,2230,0.298206278027,0.701793721973
242,DEKALB,846,COVINGTON,83,929,0.0893433799785,0.910656620022
243,DEKALB,349,COVINGTON HWY LIBRAR,19,368,0.0516304347826,0.948369565217
244,DEKALB,782,CROSS KEYS HIGH,483,1265,0.381818181818,0.618181818182
245,DEKALB,1569,CROSSROADS,78,1647,0.0473588342441,0.952641165756
246,DEKALB,1077,DORAVILLE NORTH,380,1457,0.260809883322,0.739190116678
247,DEKALB,488,DORAVILLE SOUTH,203,691,0.293777134588,0.706222865412
248,DEKALB,1903,DRESDEN ELEM,726,2629,0.276150627615,0.723849372385
249,DEKALB,1554,DRUID HILLS HIGH,279,1833,0.152209492635,0.847790507365
250,DEKALB,986,DUNAIRE ELEM,133,1119,0.118856121537,0.881143878463
251,DEKALB,1069,DUNWOODY,722,1791,0.403126744835,0.596873255165
252,DEKALB,662,DUNWOODY HIGH,766,1428,0.536414565826,0.463585434174
253,DEKALB,779,DUNWOODY LIBRARY,1039,1818,0.571507150715,0.428492849285
254,DEKALB,2095,EAST LAKE ELEM,186,2281,0.0815431828146,0.918456817185
255,DEKALB,787,EMBRY HILLS,508,1295,0.392277992278,0.607722007722
256,DEKALB,663,EMORY ROAD,124,787,0.157560355781,0.842439644219
257,DEKALB,1728,EMORY SOUTH,470,2198,0.213830755232,0.786169244768
258,DEKALB,2603,EPWORTH,281,2884,0.0974341192788,0.902565880721
259,DEKALB,1222,EVANSDALE ELEM,510,1732,0.294457274827,0.705542725173
260,DEKALB,2250,FAIRINGTON ELEM,62,2312,0.0268166089965,0.973183391003
261,DEKALB,1300,FERNBANK ELEM,320,1620,0.197530864198,0.802469135802
262,DEKALB,1130,FLAKES MILL FIRE STA,29,1159,0.0250215703192,0.974978429681
263,DEKALB,1705,FLAT ROCK ELEM,58,1763,0.0328984685196,0.96710153148
264,DEKALB,1095,FLAT SHOALS,26,1121,0.0231935771632,0.976806422837
265,DEKALB,1127,FLAT SHOALS ELEM,24,1151,0.0208514335361,0.979148566464
266,DEKALB,1187,FLAT SHOALS LIBRARY,26,1213,0.0214344600165,0.978565539984
267,DEKALB,2080,FLAT SHOALS PARKWAY,71,2151,0.0330079033008,0.966992096699
268,DEKALB,1520,FREEDOM MIDDLE,161,1681,0.0957763236169,0.904223676383
269,DEKALB,1303,GEORGETOWN SQUARE,851,2154,0.395078922934,0.604921077066
270,DEKALB,804,GLENHAVEN,71,875,0.0811428571429,0.918857142857
271,DEKALB,559,GLENNWOOD - 04,77,636,0.12106918239,0.87893081761
272,DEKALB,718,GLENNWOOD - 05,104,822,0.126520681265,0.873479318735
273,DEKALB,965,GLENWOOD ROAD,56,1021,0.0548481880509,0.945151811949
274,DEKALB,1756,GRESHAM ROAD,99,1855,0.0533692722372,0.946630727763
275,DEKALB,1645,HAMBRICK ELEM,197,1842,0.106948968512,0.893051031488
276,DEKALB,940,HARRIS-MARGARET HARR,236,1176,0.200680272109,0.799319727891
277,DEKALB,2200,HARRIS-NARVIE J. HAR,40,2240,0.0178571428571,0.982142857143
278,DEKALB,1677,HAWTHORNE ELEM,590,2267,0.260255844729,0.739744155271
279,DEKALB,1299,HENDERSON MILL ELEM,665,1964,0.338594704684,0.661405295316
280,DEKALB,722,HUGH HOWELL,561,1283,0.437256430242,0.562743569758
281,DEKALB,1310,HUNTLEY HILLS ELEM,503,1813,0.277440706012,0.722559293988
282,DEKALB,965,IDLEWOOD ELEM,258,1223,0.210956663941,0.789043336059
283,DEKALB,842,INDIAN CREEK ELEM,133,975,0.13641025641,0.86358974359
284,DEKALB,689,JOHNSON ESTATES,191,880,0.217045454545,0.782954545455
285,DEKALB,1398,JOLLY ELEM,246,1644,0.149635036496,0.850364963504
286,DEKALB,802,KELLEY CHAPEL ROAD,37,839,0.0441001191895,0.95589988081
287,DEKALB,1492,KELLEY LAKE ELEM,44,1536,0.0286458333333,0.971354166667
288,DEKALB,2801,KING-ML KING JR HIGH,64,2865,0.0223385689354,0.977661431065
289,DEKALB,724,KINGSLEY ELEM,1042,1766,0.590033975085,0.409966024915
290,DEKALB,1185,KNOLLWOOD ELEM,46,1231,0.0373679935012,0.962632006499
291,DEKALB,782,KITTREDGE ELEM,678,1460,0.464383561644,0.535616438356
292,DEKALB,1391,LAKESIDE HIGH,812,2203,0.368588288697,0.631411711303
293,DEKALB,1329,LAVISTA,474,1803,0.262895174709,0.737104825291
294,DEKALB,1016,LAVISTA ROAD,395,1411,0.279943302622,0.720056697378
295,DEKALB,1748,LIN-MARY LIN ELEM,297,2045,0.145232273839,0.854767726161
296,DEKALB,618,LITHONIA,51,669,0.0762331838565,0.923766816143
297,DEKALB,1600,LITHONIA HIGH,33,1633,0.0202082057563,0.979791794244
298,DEKALB,589,LIVSEY ELEM,454,1043,0.435282837967,0.564717162033
299,DEKALB,2298,MARBUT ELEM,51,2349,0.021711366539,0.978288633461
300,DEKALB,1686,MATHIS-BOB MATHIS EL,83,1769,0.0469191633691,0.953080836631
301,DEKALB,1124,MCLENDON,217,1341,0.161819537658,0.838180462342
302,DEKALB,1124,MCNAIR ACADEMY,32,1156,0.0276816608997,0.9723183391
303,DEKALB,2026,MCNAIR HIGH,130,2156,0.0602968460111,0.939703153989
304,DEKALB,1221,MCNAIR MIDDLE,40,1261,0.0317208564631,0.968279143537
305,DEKALB,1376,MCWILLIAMS,39,1415,0.0275618374558,0.972438162544
306,DEKALB,1747,MEADOWVIEW ELEM,66,1813,0.0364037506895,0.963596249311
307,DEKALB,1198,MEDLOCK ELEM,331,1529,0.216481360366,0.783518639634
308,DEKALB,1181,MEMORIAL SOUTH,74,1255,0.0589641434263,0.941035856574
309,DEKALB,1727,METROPOLITAN,114,1841,0.0619228680065,0.938077131993
310,DEKALB,724,MIDVALE ELEM,704,1428,0.49299719888,0.50700280112
311,DEKALB,1289,MIDVALE ROAD,591,1880,0.314361702128,0.685638297872
312,DEKALB,1289,MIDWAY ELEM,98,1387,0.0706560922855,0.929343907714
313,DEKALB,1730,MILLER-ELDRIDGE L. M,87,1817,0.0478811227298,0.95211887727
314,DEKALB,1447,MILLER GROVE HIGH,40,1487,0.0268997982515,0.973100201748
315,DEKALB,2004,MILLER GROVE MIDDLE,36,2040,0.0176470588235,0.982352941176
316,DEKALB,1330,MILLER GROVE ROAD,47,1377,0.0341321713871,0.965867828613
317,DEKALB,965,MONTCLAIR ELEM,142,1107,0.128274616079,0.871725383921
318,DEKALB,850,MONTGOMERY ELEM,736,1586,0.464060529634,0.535939470366
319,DEKALB,759,MONTREAL,289,1048,0.275763358779,0.724236641221
320,DEKALB,765,MT. VERNON EAST,1048,1813,0.57804743519,0.42195256481
321,DEKALB,761,MT. VERNON WEST,792,1553,0.50998068255,0.49001931745
322,DEKALB,860,NORTH DECATUR,157,1017,0.154375614553,0.845624385447
323,DEKALB,1072,NORTH HAIRSTON,121,1193,0.101424979044,0.898575020956
324,DEKALB,695,NORTH PEACHTREE,333,1028,0.323929961089,0.676070038911
325,DEKALB,683,NORTHLAKE,318,1001,0.317682317682,0.682317682318
326,DEKALB,1001,OAK GROVE ELEM,536,1537,0.34873129473,0.65126870527
327,DEKALB,2569,OAK VIEW ELEM,43,2612,0.0164624808576,0.983537519142
328,DEKALB,701,OAKCLIFF ELEM,238,939,0.25346112886,0.74653887114
329,DEKALB,1856,OAKHURST,192,2048,0.09375,0.90625
330,DEKALB,829,PANOLA,51,880,0.0579545454545,0.942045454545
331,DEKALB,1160,PANOLA ROAD,24,1184,0.0202702702703,0.97972972973
332,DEKALB,970,PANOLA WAY ELEM,28,998,0.0280561122244,0.971943887776
333,DEKALB,986,PEACHCREST ELEM,79,1065,0.0741784037559,0.925821596244
334,DEKALB,1417,PEACHTREE MIDDLE,589,2006,0.293619142572,0.706380857428
335,DEKALB,352,PINE LAKE,47,399,0.117794486216,0.882205513784
336,DEKALB,911,PINEY GROVE,40,951,0.0420609884332,0.957939011567
337,DEKALB,1661,PLEASANTDALE ELEM,329,1990,0.165326633166,0.834673366834
338,DEKALB,1507,PONCE DE LEON,178,1685,0.105637982196,0.894362017804
339,DEKALB,1296,PRINCETON ELEM,54,1350,0.04,0.96
340,DEKALB,2162,RAINBOW ELEM,76,2238,0.0339588918677,0.966041108132
341,DEKALB,1707,REDAN ELEM,57,1764,0.0323129251701,0.96768707483
342,DEKALB,1376,REDAN MIDDLE,70,1446,0.0484094052559,0.951590594744
343,DEKALB,1427,REDAN ROAD,63,1490,0.0422818791946,0.957718120805
344,DEKALB,2055,REDAN-TROTTI LIBRARY,57,2112,0.0269886363636,0.973011363636
345,DEKALB,979,REHOBOTH,434,1413,0.307147912243,0.692852087757
346,DEKALB,1070,RENFROE MIDDLE,99,1169,0.0846877673225,0.915312232678
347,DEKALB,1508,ROCK CHAPEL ELEM,72,1580,0.0455696202532,0.954430379747
348,DEKALB,1989,ROCK CHAPEL ROAD,168,2157,0.0778859527121,0.922114047288
349,DEKALB,1506,ROCKBRIDGE ELEM,136,1642,0.0828258221681,0.917174177832
350,DEKALB,2145,ROCKBRIDGE ROAD,97,2242,0.0432649420161,0.956735057984
351,DEKALB,1556,ROWLAND ELEM,108,1664,0.0649038461538,0.935096153846
352,DEKALB,1044,ROWLAND ROAD,107,1151,0.0929626411816,0.907037358818
353,DEKALB,1379,SAGAMORE HILLS ELEM,740,2119,0.349221330816,0.650778669184
354,DEKALB,2151,SALEM MIDDLE,68,2219,0.0306444344299,0.96935556557
355,DEKALB,1305,SCOTT,303,1608,0.188432835821,0.811567164179
356,DEKALB,2464,SHADOW ROCK ELEM,116,2580,0.0449612403101,0.95503875969
357,DEKALB,786,SHAMROCK,297,1083,0.274238227147,0.725761772853
358,DEKALB,1700,SHAW-ROBERT SHAW ELE,247,1947,0.126861838726,0.873138161274
359,DEKALB,1560,SILVER LAKE,1332,2892,0.460580912863,0.539419087137
360,DEKALB,663,SKYLAND,515,1178,0.437181663837,0.562818336163
361,DEKALB,809,SMOKE RISE ELEM,678,1487,0.455951580363,0.544048419637
362,DEKALB,1091,SNAPFINGER ELEM,45,1136,0.0396126760563,0.960387323944
363,DEKALB,1186,SNAPFINGER ROAD NORT,52,1238,0.0420032310178,0.957996768982
364,DEKALB,1190,SNAPFINGER ROAD SOUT,47,1237,0.0379951495554,0.962004850445
365,DEKALB,1918,SOUTH DESHON,51,1969,0.0259014728288,0.974098527171
366,DEKALB,1890,SOUTH HAIRSTON,89,1979,0.044972208186,0.955027791814
367,DEKALB,1871,STEPHENSON HIGH,117,1988,0.0588531187123,0.941146881288
368,DEKALB,2026,STEPHENSON MIDDLE,126,2152,0.0585501858736,0.941449814126
369,DEKALB,1239,STONE MILL ELEM,87,1326,0.0656108597285,0.934389140271
370,DEKALB,1231,STONE MOUNTAIN CHAMP,158,1389,0.113750899928,0.886249100072
371,DEKALB,1030,STONE MOUNTAIN ELEM,408,1438,0.283727399166,0.716272600834
372,DEKALB,636,STONE MOUNTAIN LIBRA,161,797,0.202007528231,0.797992471769
373,DEKALB,1036,STONE MOUNTAIN MIDDL,87,1123,0.0774710596616,0.922528940338
374,DEKALB,765,STONEVIEW ELEM,46,811,0.0567200986436,0.943279901356
375,DEKALB,1403,TERRY MILL ELEM,56,1459,0.0383824537354,0.961617546265
376,DEKALB,482,TILLY MILL ROAD,587,1069,0.54911131899,0.45088868101
377,DEKALB,920,TONEY ELEM,30,950,0.0315789473684,0.968421052632
378,DEKALB,1134,TUCKER,871,2005,0.434413965087,0.565586034913
379,DEKALB,1119,TUCKER LIBRARY,543,1662,0.326714801444,0.673285198556
380,DEKALB,469,VALLEY BROOK,149,618,0.241100323625,0.758899676375
381,DEKALB,486,WADSWORTH ELEM - 05,2,488,0.00409836065574,0.995901639344
382,DEKALB,1054,WADSWORTH ELEM,36,1090,0.0330275229358,0.966972477064
383,DEKALB,523,WARREN TECH,258,781,0.330345710627,0.669654289373
384,DEKALB,1881,WESLEY CHAPEL LIBRAR,51,1932,0.026397515528,0.973602484472
385,DEKALB,1327,WHITE OAK,43,1370,0.0313868613139,0.968613138686
386,DEKALB,2006,WHITEFOORD ELEM,170,2176,0.078125,0.921875
387,DEKALB,1303,WINNONA PARK ELEM,135,1438,0.0938803894298,0.90611961057
388,DEKALB,509,WINTERS CHAPEL,486,995,0.488442211055,0.511557788945
389,DEKALB,1799,WOODRIDGE ELEM,123,1922,0.0639958376691,0.936004162331
390,DEKALB,3149,WOODROW ROAD,145,3294,0.0440194292653,0.955980570735
391,DEKALB,974,WOODWARD ELEM,397,1371,0.289569657185,0.710430342815
392,DEKALB,2075,WYNBROOKE ELEM,128,2203,0.0581025873808,0.941897412619
393,DEKALB,1143,YOUNG ROAD,35,1178,0.0297113752122,0.970288624788
394,FULTON,1877,01A,172,2049,0.0839433870181,0.916056612982
395,FULTON,2288,01B,242,2530,0.095652173913,0.904347826087
396,FULTON,576,01C,19,595,0.0319327731092,0.968067226891
397,FULTON,265,01D,22,287,0.0766550522648,0.923344947735
398,FULTON,2903,01E,283,3186,0.0888261142498,0.91117388575
399,FULTON,436,01F,16,452,0.0353982300885,0.964601769912
400,FULTON,375,01H,20,395,0.0506329113924,0.949367088608
401,FULTON,1151,01J,40,1191,0.0335852225021,0.966414777498
402,FULTON,573,01P,17,590,0.028813559322,0.971186440678
403,FULTON,553,01R,7,560,0.0125,0.9875
404,FULTON,793,01S,25,818,0.0305623471883,0.969437652812
405,FULTON,692,01T,49,741,0.0661268556005,0.933873144399
406,FULTON,1802,02A,453,2255,0.20088691796,0.79911308204
407,FULTON,1041,02B,178,1219,0.146021328958,0.853978671042
408,FULTON,1111,02C,89,1200,0.0741666666667,0.925833333333
409,FULTON,2167,02D,239,2406,0.0993349958437,0.900665004156
410,FULTON,1209,02E,152,1361,0.111682586334,0.888317413666
411,FULTON,1697,02F1,216,1913,0.112911657083,0.887088342917
412,FULTON,419,02F2,47,466,0.100858369099,0.899141630901
413,FULTON,1958,02G,247,2205,0.11201814059,0.88798185941
414,FULTON,1680,02J,203,1883,0.10780669145,0.89219330855
415,FULTON,819,02K,120,939,0.127795527157,0.872204472843
416,FULTON,2936,02L1,549,3485,0.157532281205,0.842467718795
417,FULTON,573,02L2,130,703,0.184921763869,0.815078236131
418,FULTON,390,02S,30,420,0.0714285714286,0.928571428571
419,FULTON,219,02W,51,270,0.188888888889,0.811111111111
420,FULTON,757,03A,21,778,0.0269922879177,0.973007712082
421,FULTON,201,03B,2,203,0.00985221674877,0.990147783251
422,FULTON,733,03C,14,747,0.0187416331995,0.981258366801
423,FULTON,389,03D,10,399,0.0250626566416,0.974937343358
424,FULTON,878,03E,39,917,0.0425299890949,0.957470010905
425,FULTON,932,03F,174,1106,0.157323688969,0.842676311031
426,FULTON,297,03G,6,303,0.019801980198,0.980198019802
427,FULTON,384,03H,9,393,0.0229007633588,0.977099236641
428,FULTON,643,03I,120,763,0.157273918742,0.842726081258
429,FULTON,203,03L,10,213,0.0469483568075,0.953051643192
430,FULTON,334,03M,87,421,0.206650831354,0.793349168646
431,FULTON,862,03N,35,897,0.0390189520624,0.960981047938
432,FULTON,1577,03P1A,243,1820,0.133516483516,0.866483516484
433,FULTON,18,03P2,0,18,0.0,1.0
434,FULTON,334,03S,7,341,0.0205278592375,0.979472140762
435,FULTON,707,03T,32,739,0.043301759134,0.956698240866
436,FULTON,491,04A,11,502,0.0219123505976,0.978087649402
437,FULTON,923,04B,23,946,0.0243128964059,0.975687103594
438,FULTON,64,04C,0,64,0.0,1.0
439,FULTON,710,04D,17,727,0.0233837689133,0.976616231087
440,FULTON,845,04F,77,922,0.0835140997831,0.916485900217
441,FULTON,304,04G,8,312,0.025641025641,0.974358974359
442,FULTON,490,04I,52,542,0.0959409594096,0.90405904059
443,FULTON,398,04J,4,402,0.00995024875622,0.990049751244
444,FULTON,1126,04K,34,1160,0.0293103448276,0.970689655172
445,FULTON,721,04L,27,748,0.0360962566845,0.963903743316
446,FULTON,318,04M,8,326,0.0245398773006,0.975460122699
447,FULTON,1111,04S,23,1134,0.0202821869489,0.979717813051
448,FULTON,540,04T,9,549,0.016393442623,0.983606557377
449,FULTON,1185,04V,20,1205,0.0165975103734,0.983402489627
450,FULTON,648,04W,8,656,0.0121951219512,0.987804878049
451,FULTON,911,04X1,28,939,0.0298189563365,0.970181043663
452,FULTON,314,04X2,8,322,0.0248447204969,0.975155279503
453,FULTON,1461,05A1,146,1607,0.090852520224,0.909147479776
454,FULTON,1499,05A2,119,1618,0.0735475896168,0.926452410383
455,FULTON,841,05B,54,895,0.0603351955307,0.939664804469
456,FULTON,61,05C,3,64,0.046875,0.953125
457,FULTON,98,05D,6,104,0.0576923076923,0.942307692308
458,FULTON,71,05F,7,78,0.0897435897436,0.910256410256
459,FULTON,345,05J,47,392,0.119897959184,0.880102040816
460,FULTON,1236,05K,84,1320,0.0636363636364,0.936363636364
461,FULTON,1009,06B,197,1206,0.163349917081,0.836650082919
462,FULTON,4536,06D,1148,5684,0.20197044335,0.79802955665
463,FULTON,1206,06E,252,1458,0.172839506173,0.827160493827
464,FULTON,1451,06F,280,1731,0.161756210283,0.838243789717
465,FULTON,307,06G,53,360,0.147222222222,0.852777777778
466,FULTON,1440,06I,233,1673,0.13927077107,0.86072922893
467,FULTON,1481,06J,303,1784,0.169843049327,0.830156950673
468,FULTON,494,06L1,144,638,0.225705329154,0.774294670846
469,FULTON,336,06L2,132,468,0.282051282051,0.717948717949
470,FULTON,792,06N,340,1132,0.30035335689,0.69964664311
471,FULTON,243,06Q,35,278,0.125899280576,0.874100719424
472,FULTON,883,06R,210,1093,0.192131747484,0.807868252516
473,FULTON,2115,07A,1746,3861,0.452214452214,0.547785547786
474,FULTON,892,07B,1144,2036,0.561886051081,0.438113948919
475,FULTON,1295,07C,1149,2444,0.470130932897,0.529869067103
476,FULTON,1281,07D,988,2269,0.435434111944,0.564565888056
477,FULTON,896,07E,430,1326,0.324283559578,0.675716440422
478,FULTON,1092,07F,787,1879,0.418839808409,0.581160191591
479,FULTON,768,07H,588,1356,0.433628318584,0.566371681416
480,FULTON,1117,07J,606,1723,0.351712130006,0.648287869994
481,FULTON,774,07M,438,1212,0.361386138614,0.638613861386
482,FULTON,792,07N,188,980,0.191836734694,0.808163265306
483,FULTON,923,08A,939,1862,0.504296455424,0.495703544576
484,FULTON,979,08B,1217,2196,0.554189435337,0.445810564663
485,FULTON,326,08C,602,928,0.648706896552,0.351293103448
486,FULTON,280,08D,436,716,0.608938547486,0.391061452514
487,FULTON,835,08E,964,1799,0.535853251807,0.464146748193
488,FULTON,611,08F1,875,1486,0.588829071332,0.411170928668
489,FULTON,923,08G,671,1594,0.42095357591,0.57904642409
490,FULTON,845,08H,828,1673,0.494919306635,0.505080693365
491,FULTON,1045,08J,852,1897,0.449130205588,0.550869794412
492,FULTON,394,08K,258,652,0.395705521472,0.604294478528
493,FULTON,1670,08L,747,2417,0.309060819197,0.690939180803
494,FULTON,553,08M,691,1244,0.555466237942,0.444533762058
495,FULTON,226,08N1,313,539,0.580705009276,0.419294990724
496,FULTON,496,08N2,397,893,0.444568868981,0.555431131019
497,FULTON,632,08P,168,800,0.21,0.79
498,FULTON,1491,09A,464,1955,0.237340153453,0.762659846547
499,FULTON,196,09B,6,202,0.029702970297,0.970297029703
500,FULTON,1547,09C,33,1580,0.0208860759494,0.979113924051
501,FULTON,909,09D,19,928,0.020474137931,0.979525862069
502,FULTON,1221,09E,49,1270,0.0385826771654,0.961417322835
503,FULTON,1487,09F,967,2454,0.394050529747,0.605949470253
504,FULTON,1471,09G,398,1869,0.212948100589,0.787051899411
505,FULTON,465,09H,83,548,0.151459854015,0.848540145985
506,FULTON,516,09I,10,526,0.0190114068441,0.980988593156
507,FULTON,1916,09K,59,1975,0.0298734177215,0.970126582278
508,FULTON,992,09M,288,1280,0.225,0.775
509,FULTON,1709,10A,29,1738,0.0166858457998,0.9833141542
510,FULTON,2492,10B,56,2548,0.021978021978,0.978021978022
511,FULTON,1249,10C,15,1264,0.0118670886076,0.988132911392
512,FULTON,2035,10D,52,2087,0.0249161475803,0.97508385242
513,FULTON,543,10E,8,551,0.0145190562613,0.985480943739
514,FULTON,597,10F,18,615,0.0292682926829,0.970731707317
515,FULTON,818,10G,21,839,0.0250297973778,0.974970202622
516,FULTON,214,10H,3,217,0.0138248847926,0.986175115207
517,FULTON,1091,10H,31,1122,0.0276292335116,0.972370766488
518,FULTON,240,10I,10,250,0.04,0.96
519,FULTON,428,10J,11,439,0.0250569476082,0.974943052392
520,FULTON,841,10K,32,873,0.0366552119129,0.963344788087
521,FULTON,1216,10M,31,1247,0.0248596631917,0.975140336808
522,FULTON,712,10P,17,729,0.0233196159122,0.976680384088
523,FULTON,365,10R,8,373,0.0214477211796,0.97855227882
524,FULTON,3022,11B,64,3086,0.0207388204796,0.97926117952
525,FULTON,1873,11C,33,1906,0.0173137460651,0.982686253935
526,FULTON,610,11E1,16,626,0.0255591054313,0.974440894569
527,FULTON,495,11E2,6,501,0.0119760479042,0.988023952096
528,FULTON,1707,11E3,37,1744,0.0212155963303,0.97878440367
529,FULTON,968,11G,19,987,0.0192502532928,0.980749746707
530,FULTON,346,11H,12,358,0.0335195530726,0.966480446927
531,FULTON,986,11J,28,1014,0.0276134122288,0.972386587771
532,FULTON,1077,11K,27,1104,0.0244565217391,0.975543478261
533,FULTON,1567,11M,29,1596,0.0181704260652,0.981829573935
534,FULTON,1374,11N,30,1404,0.0213675213675,0.978632478632
535,FULTON,1010,11P,18,1028,0.0175097276265,0.982490272374
536,FULTON,765,11R,16,781,0.0204865556978,0.979513444302
537,FULTON,2373,12A,109,2482,0.0439161966156,0.956083803384
538,FULTON,565,12D,11,576,0.0190972222222,0.980902777778
539,FULTON,561,12E1,26,587,0.0442930153322,0.955706984668
540,FULTON,436,12F,10,446,0.0224215246637,0.977578475336
541,FULTON,423,12G,27,450,0.06,0.94
542,FULTON,1654,12H,45,1699,0.0264861683343,0.973513831666
543,FULTON,421,12I,7,428,0.0163551401869,0.983644859813
544,FULTON,1200,12J,26,1226,0.021207177814,0.978792822186
545,FULTON,1280,12K,63,1343,0.0469099032018,0.953090096798
546,FULTON,251,12L,5,256,0.01953125,0.98046875
547,FULTON,1243,12M,29,1272,0.0227987421384,0.977201257862
548,FULTON,359,12N,8,367,0.0217983651226,0.978201634877
549,FULTON,904,12S,19,923,0.0205850487541,0.979414951246
550,FULTON,578,AP01A,730,1308,0.558103975535,0.441896024465
551,FULTON,246,AP01B,203,449,0.452115812918,0.547884187082
552,FULTON,654,AP01C,830,1484,0.559299191375,0.440700808625
553,FULTON,292,AP01D,221,513,0.430799220273,0.569200779727
554,FULTON,109,AP02B,122,231,0.528138528139,0.471861471861
555,FULTON,297,AP03,94,391,0.240409207161,0.759590792839
556,FULTON,435,AP04A,727,1162,0.625645438898,0.374354561102
557,FULTON,137,AP04B,165,302,0.546357615894,0.453642384106
558,FULTON,1268,AP05,1788,3056,0.585078534031,0.414921465969
559,FULTON,484,AP06,733,1217,0.602300739523,0.397699260477
560,FULTON,960,AP07A,1088,2048,0.53125,0.46875
561,FULTON,459,AP07B,602,1061,0.567389255419,0.432610744581
562,FULTON,1317,AP09A,1363,2680,0.508582089552,0.491417910448
563,FULTON,299,AP09B,223,522,0.427203065134,0.572796934866
564,FULTON,874,AP021,1004,1878,0.534611288605,0.465388711395
565,FULTON,705,AP022,676,1381,0.489500362056,0.510499637944
566,FULTON,247,AP10,420,667,0.629685157421,0.370314842579
567,FULTON,257,AP12A,141,398,0.354271356784,0.645728643216
568,FULTON,255,AP12B,118,373,0.316353887399,0.683646112601
569,FULTON,352,AP12C,472,824,0.572815533981,0.427184466019
570,FULTON,837,AP13,913,1750,0.521714285714,0.478285714286
571,FULTON,932,AP14,1074,2006,0.535393818544,0.464606181456
572,FULTON,106,CH01,44,150,0.293333333333,0.706666666667
573,FULTON,133,CH02,181,314,0.576433121019,0.423566878981
574,FULTON,75,CH03,160,235,0.68085106383,0.31914893617
575,FULTON,185,CH04A,204,389,0.52442159383,0.47557840617
576,FULTON,49,CH05,211,260,0.811538461538,0.188461538462
577,FULTON,156,CP01B,72,228,0.315789473684,0.684210526316
578,FULTON,525,CP011,126,651,0.193548387097,0.806451612903
579,FULTON,585,CP012,163,748,0.217914438503,0.782085561497
580,FULTON,442,CP02,73,515,0.141747572816,0.858252427184
581,FULTON,22,CP04,2,24,0.0833333333333,0.916666666667
582,FULTON,57,CP05B,1,58,0.0172413793103,0.98275862069
583,FULTON,871,CP051,39,910,0.0428571428571,0.957142857143
584,FULTON,210,CP06A,12,222,0.0540540540541,0.945945945946
585,FULTON,432,CP07A,10,442,0.0226244343891,0.977375565611
586,FULTON,132,CP081,4,136,0.0294117647059,0.970588235294
587,FULTON,81,CP083,1,82,0.0121951219512,0.987804878049
588,FULTON,200,CP08A,4,204,0.0196078431373,0.980392156863
589,FULTON,2562,EP01,266,2828,0.0940594059406,0.905940594059
590,FULTON,2620,EP02,274,2894,0.0946786454734,0.905321354527
591,FULTON,3302,EP03,173,3475,0.0497841726619,0.950215827338
592,FULTON,2540,EP04,84,2624,0.032012195122,0.967987804878
593,FULTON,1021,EP04,17,1038,0.0163776493256,0.983622350674
594,FULTON,4169,FA01A,596,4765,0.125078698846,0.874921301154
595,FULTON,355,FA01B,20,375,0.0533333333333,0.946666666667
596,FULTON,1196,HP01,492,1688,0.291469194313,0.708530805687
597,FULTON,1857,JC01,1316,3173,0.414749448471,0.585250551529
598,FULTON,720,JC02,694,1414,0.490806223479,0.509193776521
599,FULTON,195,JC03A,198,393,0.503816793893,0.496183206107
600,FULTON,547,JC03B,373,920,0.405434782609,0.594565217391
601,FULTON,1403,JC04A,1379,2782,0.495686556434,0.504313443566
602,FULTON,91,JC04B,74,165,0.448484848485,0.551515151515
603,FULTON,735,JC05,649,1384,0.468930635838,0.531069364162
604,FULTON,709,JC06,1023,1732,0.59064665127,0.40935334873
605,FULTON,1387,JC07,1205,2592,0.464891975309,0.535108024691
606,FULTON,864,JC08,952,1816,0.52422907489,0.47577092511
607,FULTON,1054,JC09,802,1856,0.432112068966,0.567887931034
608,FULTON,796,JC10,616,1412,0.436260623229,0.563739376771
609,FULTON,895,JC11,1223,2118,0.577431539188,0.422568460812
610,FULTON,577,JC12,1174,1751,0.670474014849,0.329525985151
611,FULTON,448,JC13A,1008,1456,0.692307692308,0.307692307692
612,FULTON,37,JC13B,153,190,0.805263157895,0.194736842105
613,FULTON,705,JC14,1000,1705,0.58651026393,0.41348973607
614,FULTON,294,JC15,201,495,0.406060606061,0.593939393939
615,FULTON,796,JC16,905,1701,0.532039976484,0.467960023516
616,FULTON,790,JC18,1096,1886,0.58112407211,0.41887592789
617,FULTON,1232,JC19,1228,2460,0.49918699187,0.50081300813
618,FULTON,625,ML011,981,1606,0.610834371108,0.389165628892
619,FULTON,103,ML012,232,335,0.692537313433,0.307462686567
620,FULTON,19,ML01B,37,56,0.660714285714,0.339285714286
621,FULTON,300,ML021,938,1238,0.757673667205,0.242326332795
622,FULTON,35,ML022,104,139,0.748201438849,0.251798561151
623,FULTON,264,ML023,715,979,0.730337078652,0.269662921348
624,FULTON,16,ML024,57,73,0.780821917808,0.219178082192
625,FULTON,743,ML03,1790,2533,0.706671930517,0.293328069483
626,FULTON,431,ML04A,735,1166,0.630360205832,0.369639794168
627,FULTON,248,ML04B,564,812,0.694581280788,0.305418719212
628,FULTON,18,ML04C,52,70,0.742857142857,0.257142857143
629,FULTON,17,ML05A,13,30,0.433333333333,0.566666666667
630,FULTON,83,ML05B,185,268,0.690298507463,0.309701492537
631,FULTON,1241,ML05C,1410,2651,0.53187476424,0.46812523576
632,FULTON,681,ML06A,366,1047,0.349570200573,0.650429799427
633,FULTON,1031,ML06B,708,1739,0.40713053479,0.59286946521
634,FULTON,32,ML071,45,77,0.584415584416,0.415584415584
635,FULTON,218,ML072,546,764,0.714659685864,0.285340314136
636,FULTON,135,ML07A,330,465,0.709677419355,0.290322580645
637,FULTON,160,MP01,149,309,0.482200647249,0.517799352751
638,FULTON,1073,PA01,389,1462,0.266073871409,0.733926128591
639,FULTON,1248,RW01,2033,3281,0.619628162146,0.380371837854
640,FULTON,1231,RW02,1444,2675,0.539813084112,0.460186915888
641,FULTON,1433,RW03,1186,2619,0.452844597174,0.547155402826
642,FULTON,599,RW04,672,1271,0.52871754524,0.47128245476
643,FULTON,707,RW05,423,1130,0.374336283186,0.625663716814
644,FULTON,932,RW06,921,1853,0.497031840259,0.502968159741
645,FULTON,526,RW07A,111,637,0.174254317111,0.825745682889
646,FULTON,169,RW07B,63,232,0.271551724138,0.728448275862
647,FULTON,523,RW08,955,1478,0.646143437077,0.353856562923
648,FULTON,1394,RW09,2745,4139,0.663203672385,0.336796327615
649,FULTON,932,RW10,1357,2289,0.592835299257,0.407164700743
650,FULTON,823,RW11A,819,1642,0.498781973203,0.501218026797
651,FULTON,1617,RW12,2547,4164,0.611671469741,0.388328530259
652,FULTON,1057,RW13,1282,2339,0.548097477555,0.451902522445
653,FULTON,559,RW16,744,1303,0.570990023024,0.429009976976
654,FULTON,965,RW17,659,1624,0.40578817734,0.59421182266
655,FULTON,569,RW19,855,1424,0.600421348315,0.399578651685
656,FULTON,859,RW20,1038,1897,0.547179757512,0.452820242488
657,FULTON,816,RW21,1323,2139,0.618513323983,0.381486676017
658,FULTON,1393,RW22A,937,2330,0.402145922747,0.597854077253
659,FULTON,2705,SC01B,86,2791,0.0308133285561,0.969186671444
660,FULTON,622,SC02,20,642,0.0311526479751,0.968847352025
661,FULTON,390,SC04,221,611,0.36170212766,0.63829787234
662,FULTON,419,SC05A,8,427,0.0187353629977,0.981264637002
663,FULTON,2015,SC05B,67,2082,0.0321805955812,0.967819404419
664,FULTON,1494,SC05D,134,1628,0.0823095823096,0.91769041769
665,FULTON,3056,SC07A,348,3404,0.10223266745,0.89776733255
666,FULTON,1906,SC08B,63,1969,0.0319959370239,0.968004062976
667,FULTON,56,SC08C,0,56,0.0,1.0
668,FULTON,316,SC08D,7,323,0.0216718266254,0.978328173375
669,FULTON,273,SC08E,1,274,0.0036496350365,0.996350364964
670,FULTON,360,SC08F,19,379,0.0501319261214,0.949868073879
671,FULTON,2,SC08G,0,2,0.0,1.0
672,FULTON,1731,SC09A,79,1810,0.0436464088398,0.95635359116
673,FULTON,1036,SC09B,32,1068,0.0299625468165,0.970037453184
674,FULTON,780,SC10,27,807,0.0334572490706,0.966542750929
675,FULTON,825,SC11A,23,848,0.0271226415094,0.972877358491
676,FULTON,927,SC11B,24,951,0.0252365930599,0.97476340694
677,FULTON,1477,SC13,85,1562,0.0544174135723,0.945582586428
678,FULTON,523,SC14,18,541,0.0332717190388,0.966728280961
679,FULTON,3893,SC15,168,4061,0.0413691209062,0.958630879094
680,FULTON,2858,SC16,62,2920,0.0212328767123,0.978767123288
681,FULTON,35,SC17A,0,35,0.0,1.0
682,FULTON,644,SC17C,28,672,0.0416666666667,0.958333333333
683,FULTON,304,SC18A,11,315,0.0349206349206,0.965079365079
684,FULTON,3178,SC18B,101,3279,0.030802073803,0.969197926197
685,FULTON,111,SC19A,3,114,0.0263157894737,0.973684210526
686,FULTON,691,SC19B,23,714,0.0322128851541,0.967787114846
687,FULTON,743,SC211,29,772,0.0375647668394,0.962435233161
688,FULTON,1740,SC212,112,1852,0.060475161987,0.939524838013
689,FULTON,2943,SC23A,92,3035,0.030313014827,0.969686985173
690,FULTON,293,SC23B,8,301,0.0265780730897,0.97342192691
691,FULTON,1274,SC27,40,1314,0.0304414003044,0.969558599696
692,FULTON,1626,SC29A,51,1677,0.0304114490161,0.969588550984
693,FULTON,88,SC30A,2,90,0.0222222222222,0.977777777778
694,FULTON,568,SC30B,10,578,0.0173010380623,0.982698961938
695,FULTON,851,SS01,1276,2127,0.599905970851,0.400094029149
696,FULTON,409,SS02A,315,724,0.435082872928,0.564917127072
697,FULTON,539,SS02B,195,734,0.265667574932,0.734332425068
698,FULTON,487,SS03,427,914,0.467177242888,0.532822757112
699,FULTON,1212,SS04,672,1884,0.356687898089,0.643312101911
700,FULTON,650,SS05,657,1307,0.502677888294,0.497322111706
701,FULTON,451,SS06,515,966,0.533126293996,0.466873706004
702,FULTON,262,SS07A,360,622,0.578778135048,0.421221864952
703,FULTON,177,SS07B,152,329,0.462006079027,0.537993920973
704,FULTON,246,SS07C,233,479,0.48643006263,0.51356993737
705,FULTON,497,SS08A,265,762,0.347769028871,0.652230971129
706,FULTON,209,SS08B,209,418,0.5,0.5
707,FULTON,229,SS08C,133,362,0.367403314917,0.632596685083
708,FULTON,430,SS08D,280,710,0.394366197183,0.605633802817
709,FULTON,965,SS09A,1121,2086,0.537392138063,0.462607861937
710,FULTON,1114,SS09B,1265,2379,0.531736023539,0.468263976461
711,FULTON,1372,SS11A,907,2279,0.397981570864,0.602018429136
712,FULTON,488,SS11B,221,709,0.311706629055,0.688293370945
713,FULTON,117,SS11C,33,150,0.22,0.78
714,FULTON,103,SS11D,130,233,0.557939914163,0.442060085837
715,FULTON,886,SS12,834,1720,0.48488372093,0.51511627907
716,FULTON,482,SS13A,460,942,0.488322717622,0.511677282378
717,FULTON,302,SS13B,237,539,0.439703153989,0.560296846011
718,FULTON,386,SS14,577,963,0.599169262721,0.400830737279
719,FULTON,968,SS15A,195,1163,0.167669819433,0.832330180567
720,FULTON,605,SS15B,308,913,0.33734939759,0.66265060241
721,FULTON,653,SS16,833,1486,0.560565275908,0.439434724092
722,FULTON,1080,SS17,1169,2249,0.51978657181,0.48021342819
723,FULTON,224,SS18A,245,469,0.522388059701,0.477611940299
724,FULTON,78,SS18B,97,175,0.554285714286,0.445714285714
725,FULTON,1250,SS19A,447,1697,0.263406010607,0.736593989393
726,FULTON,906,SS19B,334,1240,0.26935483871,0.73064516129
727,FULTON,739,SS20,392,1131,0.346595932803,0.653404067197
728,FULTON,972,SS22,653,1625,0.401846153846,0.598153846154
729,FULTON,449,SS25,622,1071,0.580765639589,0.419234360411
730,FULTON,1477,SS26,331,1808,0.183075221239,0.816924778761
731,FULTON,964,SS29A,680,1644,0.413625304136,0.586374695864
732,FULTON,379,SS31,330,709,0.465444287729,0.534555712271
733,FULTON,1691,UC01A,81,1772,0.0457110609481,0.954288939052
734,FULTON,203,UC01B,3,206,0.0145631067961,0.985436893204
735,FULTON,69,UC01E,2,71,0.0281690140845,0.971830985915
736,FULTON,3868,UC02A,167,4035,0.0413878562577,0.958612143742
737,FULTON,10,UC02B,6,16,0.375,0.625
738,FULTON,1010,UC031,281,1291,0.217660728118,0.782339271882
739,FULTON,76,UC032,13,89,0.14606741573,0.85393258427
740,GWINNETT,1465,HARBINS A,2020,3485,0.57962697274,0.42037302726
741,GWINNETT,1695,ROCKBRIDGE A,538,2233,0.240931482311,0.759068517689
742,GWINNETT,1363,DACULA,1300,2663,0.488171235449,0.511828764551
743,GWINNETT,435,SUWANEE A,464,899,0.516129032258,0.483870967742
744,GWINNETT,754,BAYCREEK A,1010,1764,0.572562358277,0.427437641723
745,GWINNETT,1206,GOODWINS A,938,2144,0.4375,0.5625
746,GWINNETT,1462,DULUTH A,1301,2763,0.47086500181,0.52913499819
747,GWINNETT,812,DUNCANS A,2105,2917,0.721631813507,0.278368186493
748,GWINNETT,876,PUCKETTS A,2132,3008,0.708776595745,0.291223404255
749,GWINNETT,520,CATES A,932,1452,0.641873278237,0.358126721763
750,GWINNETT,836,BERKSHIRE A,381,1217,0.313064913722,0.686935086278
751,GWINNETT,2085,BERKSHIRE B,709,2794,0.253758052971,0.746241947029
752,GWINNETT,496,DUNCANS C,1506,2002,0.752247752248,0.247752247752
753,GWINNETT,886,GARNERS A,1321,2207,0.598550067966,0.401449932034
754,GWINNETT,1025,LAWRENCEVILLE A,884,1909,0.463069669984,0.536930330016
755,GWINNETT,1744,LAWRENCEVILLE B,924,2668,0.346326836582,0.653673163418
756,GWINNETT,1226,MARTINS A,362,1588,0.227959697733,0.772040302267
757,GWINNETT,1079,MARTINS B,561,1640,0.342073170732,0.657926829268
758,GWINNETT,812,MARTINS C,610,1422,0.428973277075,0.571026722925
759,GWINNETT,987,PINCKNEYVILLE A,237,1224,0.19362745098,0.80637254902
760,GWINNETT,1110,PINCKNEYVILLE B,359,1469,0.244383934649,0.755616065351
761,GWINNETT,622,PINCKNEYVILLE C,611,1233,0.495539334955,0.504460665045
762,GWINNETT,723,PINCKNEYVILLE D,190,913,0.208105147864,0.791894852136
763,GWINNETT,791,SUGAR HILL A,1235,2026,0.609575518263,0.390424481737
764,GWINNETT,1038,SUGAR HILL B,1639,2677,0.612252521479,0.387747478521
765,GWINNETT,1345,HOG MOUNTAIN A,1172,2517,0.465633690902,0.534366309098
766,GWINNETT,1093,HOG MOUNTAIN B,1763,2856,0.617296918768,0.382703081232
767,GWINNETT,1296,ROCKYCREEK A,1931,3227,0.598388596219,0.401611403781
768,GWINNETT,370,CATES B,678,1048,0.646946564885,0.353053435115
769,GWINNETT,960,CATES C,677,1637,0.413561392792,0.586438607208
770,GWINNETT,703,HOG MOUNTAIN D,1105,1808,0.611172566372,0.388827433628
771,GWINNETT,833,BERKSHIRE D,927,1760,0.526704545455,0.473295454545
772,GWINNETT,596,BERKSHIRE E,710,1306,0.543644716692,0.456355283308
773,GWINNETT,621,BERKSHIRE F,408,1029,0.396501457726,0.603498542274
774,GWINNETT,735,CATES D,913,1648,0.554004854369,0.445995145631
775,GWINNETT,190,CATES D - 04,179,369,0.485094850949,0.514905149051
776,GWINNETT,867,CATES E,1009,1876,0.537846481876,0.462153518124
777,GWINNETT,760,PINCKNEYVILLE E,199,959,0.207507820647,0.792492179353
778,GWINNETT,693,PINCKNEYVILLE F,291,984,0.295731707317,0.704268292683
779,GWINNETT,1024,DUNCANS D,2670,3694,0.722793719545,0.277206280455
780,GWINNETT,1341,PINCKNEYVILLE H,1158,2499,0.463385354142,0.536614645858
781,GWINNETT,2056,BAYCREEK B,1184,3240,0.365432098765,0.634567901235
782,GWINNETT,621,LAWRENCEVILLE C,1064,1685,0.631454005935,0.368545994065
783,GWINNETT,794,MARTINS D,162,956,0.169456066946,0.830543933054
784,GWINNETT,1618,ROCKBRIDGE B,617,2235,0.276062639821,0.723937360179
785,GWINNETT,1216,GARNERS B,711,1927,0.368967306694,0.631032693306
786,GWINNETT,399,CATES F,788,1187,0.663858466723,0.336141533277
787,GWINNETT,641,CATES G,1217,1858,0.655005382131,0.344994617869
788,GWINNETT,865,DULUTH B,1016,1881,0.540138224349,0.459861775651
789,GWINNETT,593,GARNERS C,551,1144,0.481643356643,0.518356643357
790,GWINNETT,981,PINCKNEYVILLE I,310,1291,0.240123934934,0.759876065066
791,GWINNETT,958,PINCKNEYVILLE J,172,1130,0.152212389381,0.847787610619
792,GWINNETT,691,BERKSHIRE G,792,1483,0.534052596089,0.465947403911
793,GWINNETT,1294,CATES H,683,1977,0.345472938796,0.654527061204
794,GWINNETT,982,SUGAR HILL C,1905,2887,0.659854520263,0.340145479737
795,GWINNETT,834,SUGAR HILL D,1402,2236,0.627012522361,0.372987477639
796,GWINNETT,691,DULUTH C,622,1313,0.473724295506,0.526275704494
797,GWINNETT,1378,DULUTH D,874,2252,0.38809946714,0.61190053286
798,GWINNETT,1311,PINCKNEYVILLE K,349,1660,0.210240963855,0.789759036145
799,GWINNETT,1395,PINCKNEYVILLE N,315,1710,0.184210526316,0.815789473684
800,GWINNETT,1732,LAWRENCEVILLE D,547,2279,0.240017551558,0.759982448442
801,GWINNETT,630,LAWRENCEVILLE E,819,1449,0.565217391304,0.434782608696
802,GWINNETT,621,PINCKNEYVILLE L,1034,1655,0.624773413897,0.375226586103
803,GWINNETT,648,PINCKNEYVILLE M,1120,1768,0.633484162896,0.366515837104
804,GWINNETT,1332,GARNERS D,534,1866,0.286173633441,0.713826366559
805,GWINNETT,582,BERKSHIRE H,317,899,0.352614015573,0.647385984427
806,GWINNETT,1323,PINCKNEYVILLE O,346,1669,0.207309766327,0.792690233673
807,GWINNETT,1321,PUCKETTS E,1516,2837,0.53436728939,0.46563271061
808,GWINNETT,1102,CATES I,1109,2211,0.50158299412,0.49841700588
809,GWINNETT,1102,CATES J,908,2010,0.451741293532,0.548258706468
810,GWINNETT,930,GOODWINS B,1418,2348,0.603918228279,0.396081771721
811,GWINNETT,1625,LAWRENCEVILLE F,605,2230,0.27130044843,0.72869955157
812,GWINNETT,2166,MARTINS E,288,2454,0.117359413203,0.882640586797
813,GWINNETT,664,PINCKNEYVILLE P,591,1255,0.470916334661,0.529083665339
814,GWINNETT,753,PINCKNEYVILLE Q,127,880,0.144318181818,0.855681818182
815,GWINNETT,2297,ROCKBRIDGE C,646,2943,0.219503907577,0.780496092423
816,GWINNETT,1558,ROCKBRIDGE D,651,2209,0.29470348574,0.70529651426
817,GWINNETT,1751,GOODWINS C,1030,2781,0.37037037037,0.62962962963
818,GWINNETT,1109,BAYCREEK K,1156,2265,0.510375275938,0.489624724062
819,GWINNETT,623,CATES K,929,1552,0.598582474227,0.401417525773
820,GWINNETT,2112,BAYCREEK C,1558,3670,0.424523160763,0.575476839237
821,GWINNETT,1338,CATES L,1072,2410,0.444813278008,0.555186721992
822,GWINNETT,1652,DULUTH E,779,2431,0.320444261621,0.679555738379
823,GWINNETT,1157,GOODWINS D,1161,2318,0.50086281277,0.49913718723
824,GWINNETT,1154,LAWRENCEVILLE G,426,1580,0.269620253165,0.730379746835
825,GWINNETT,1070,LAWRENCEVILLE H,1421,2491,0.570453633079,0.429546366921
826,GWINNETT,911,MARTINS F,304,1215,0.250205761317,0.749794238683
827,GWINNETT,999,PINCKNEYVILLE S,586,1585,0.369716088328,0.630283911672
828,GWINNETT,1768,ROCKBRIDGE E,568,2336,0.243150684932,0.756849315068
829,GWINNETT,662,SUGAR HILL E,1092,1754,0.622576966933,0.377423033067
830,GWINNETT,1069,LAWRENCEVILLE I,721,1790,0.402793296089,0.597206703911
831,GWINNETT,1254,BAYCREEK D,1543,2797,0.551662495531,0.448337504469
832,GWINNETT,800,BERKSHIRE J,1027,1827,0.562123700055,0.437876299945
833,GWINNETT,1017,CATES M,1580,2597,0.608394301117,0.391605698883
834,GWINNETT,502,CATES N,1193,1695,0.70383480826,0.29616519174
835,GWINNETT,1850,DULUTH F,576,2426,0.237427864798,0.762572135202
836,GWINNETT,759,DULUTH G,969,1728,0.560763888889,0.439236111111
837,GWINNETT,1468,GOODWINS E,1500,2968,0.50539083558,0.49460916442
838,GWINNETT,903,GOODWINS F,843,1746,0.482817869416,0.517182130584
839,GWINNETT,918,PINCKNEYVILLE T,651,1569,0.414913957935,0.585086042065
840,GWINNETT,1075,SUWANEE B,1349,2424,0.556518151815,0.443481848185
841,GWINNETT,700,PINCKNEYVILLE U,459,1159,0.39603106126,0.60396893874
842,GWINNETT,579,PUCKETTS B,1278,1857,0.688206785137,0.311793214863
843,GWINNETT,1164,BERKSHIRE L,395,1559,0.253367543297,0.746632456703
844,GWINNETT,2635,ROCKBRIDGE F,711,3346,0.212492528392,0.787507471608
845,GWINNETT,864,SUGAR HILL F,1372,2236,0.613595706619,0.386404293381
846,GWINNETT,1213,SUWANEE C,1502,2715,0.553222836096,0.446777163904
847,GWINNETT,381,CATES O,487,868,0.561059907834,0.438940092166
848,GWINNETT,869,BAYCREEK E,895,1764,0.507369614512,0.492630385488
849,GWINNETT,459,BERKSHIRE M,602,1061,0.567389255419,0.432610744581
850,GWINNETT,856,MARTINS G,339,1195,0.283682008368,0.716317991632
851,GWINNETT,778,DULUTH H,779,1557,0.500321130379,0.499678869621
852,GWINNETT,834,BERKSHIRE N,1198,2032,0.589566929134,0.410433070866
853,GWINNETT,540,PINCKNEYVILLE V,294,834,0.352517985612,0.647482014388
854,GWINNETT,1243,PINCKNEYVILLE W,856,2099,0.407813244402,0.592186755598
855,GWINNETT,1584,MARTINS H,817,2401,0.340274885464,0.659725114536
856,GWINNETT,1356,MARTINS I,431,1787,0.241186345831,0.758813654169
857,GWINNETT,1518,MARTINS J,387,1905,0.203149606299,0.796850393701
858,GWINNETT,465,GARNERS F,520,985,0.527918781726,0.472081218274
859,GWINNETT,660,BERKSHIRE O,983,1643,0.598295800365,0.401704199635
860,GWINNETT,408,BERKSHIRE P,284,692,0.410404624277,0.589595375723
861,GWINNETT,1026,PINCKNEYVILLE X,1013,2039,0.496812162825,0.503187837175
862,GWINNETT,2422,ROCKBRIDGE G,676,3098,0.218205293738,0.781794706262
863,GWINNETT,1207,PINCKNEYVILLE Y,286,1493,0.191560616209,0.808439383791
864,GWINNETT,929,GOODWINS G,430,1359,0.316409124356,0.683590875644
865,GWINNETT,477,PINCKNEYVILLE Z,857,1334,0.642428785607,0.357571214393
866,GWINNETT,719,PINCKNEYVILLE A1,1156,1875,0.616533333333,0.383466666667
867,GWINNETT,723,LAWRENCEVILLE J,400,1123,0.356188780053,0.643811219947
868,GWINNETT,812,GOODWINS H,794,1606,0.494396014944,0.505603985056
869,GWINNETT,765,DUNCANS B,2114,2879,0.734282737061,0.265717262939
870,GWINNETT,942,SUWANEE D,1885,2827,0.66678457729,0.33321542271
871,GWINNETT,927,SUWANEE E,1593,2520,0.632142857143,0.367857142857
872,GWINNETT,882,LAWRENCEVILLE K,1049,1931,0.543241843604,0.456758156396
873,GWINNETT,893,HARBINS B,1682,2575,0.653203883495,0.346796116505
874,GWINNETT,1561,BAYCREEK F,981,2542,0.385916601101,0.614083398899
875,GWINNETT,614,PUCKETTS C,1177,1791,0.657174762702,0.342825237298
876,GWINNETT,905,HOG MOUNTAIN C,1365,2270,0.601321585903,0.398678414097
877,GWINNETT,1147,ROCKYCREEK B,1801,2948,0.61092265943,0.38907734057
878,GWINNETT,1211,DULUTH I,1504,2715,0.553959484346,0.446040515654
879,GWINNETT,2085,MARTINS K,611,2696,0.226632047478,0.773367952522
880,GWINNETT,713,SUWANEE H,1619,2332,0.694253859348,0.305746140652
881,GWINNETT,608,SUGAR HILL G,1134,1742,0.650975889782,0.349024110218
882,GWINNETT,1053,SUWANEE F,1171,2224,0.526528776978,0.473471223022
883,GWINNETT,1589,LAWRENCEVILLE L,1183,2772,0.426767676768,0.573232323232
884,GWINNETT,2368,LAWRENCEVILLE M,692,3060,0.22614379085,0.77385620915
885,GWINNETT,1632,BAYCREEK G,1315,2947,0.446216491347,0.553783508653
886,GWINNETT,1288,BAYCREEK H,2087,3375,0.61837037037,0.38162962963
887,GWINNETT,1793,BAYCREEK I,1337,3130,0.427156549521,0.572843450479
888,GWINNETT,464,BERKSHIRE Q,587,1051,0.558515699334,0.441484300666
889,GWINNETT,728,GOODWINS I,894,1622,0.551171393342,0.448828606658
890,GWINNETT,876,DULUTH K,244,1120,0.217857142857,0.782142857143
891,GWINNETT,464,HARBINS C,1074,1538,0.698309492848,0.301690507152
892,GWINNETT,1229,ROCKYCREEK C,1778,3007,0.591286997007,0.408713002993
893,GWINNETT,647,LAWRENCEVILLE N,562,1209,0.464846980976,0.535153019024
894,GWINNETT,612,PUCKETTS D,1368,1980,0.690909090909,0.309090909091
895,GWINNETT,980,SUWANEE G,1103,2083,0.529524723956,0.470475276044
896,GWINNETT,1566,BAYCREEK J,949,2515,0.377335984095,0.622664015905
